border_size=1
usage=map

Gd          , Md          , Md          , Hhd         , Gd          , Gd          , Hhd         , Md          , Md          , Hhd         , Gd          , Gd          , Hhd         , Hhd         , Hhd         , Gd          , Gs          , Gd          , Gd          , Gd          , Hhd         , Md          , Md          , Hhd         , Gd          , Re          , Gd          , Gd^Edpp     , Gd          , Gd          , Gs          , Gd          , Rd          , Re          , Gd^Vhr      , Gs          , Gg          , Gg          , Gs          , Gg          , Gg          , Rp          , Rr          , Rr          , Gg          , Hh          , Hh          , Hh          , Hh          , Mm          , Ww          , Ww          
Gd          , Hhd         , Md          , Hhd         , Hhd         , Hhd         , Md          , Md          , Hhd         , Hhd         , Gs          , Gs          , Hhd         , Md          , Gd          , Gd          , Gs          , Gs          , Hhd         , Hhd         , Hhd         , Md          , Hhd         , Hhd         , Gd          , Re          , Rd          , Gd          , Gd          , Gd^Edpp     , Gd          , Gd          , Rd          , Rd          , Gd          , Gd^Es       , Gd          , Gd          , Rd          , Gd          , Gd          , Rr          , Rr          , Hh          , Hh          , Hh          , Hh          , Hh          , Ww          , Hh          , Ww          , Ww          
Hhd         , Hhd         , Hhd         , Hhd         , Hhd         , Md          , Hhd         , Hhd         , Hhd         , Hhd         , Md          , Hh          , Hhd         , Hhd         , Hhd         , Gd          , Hhd         , Gd          , Hhd         , Md          , Md          , Gd          , Hh          , Gd          , Gd          , Gd          , Gd          , Rd          , Re          , Gd          , Gd          , Gs          , Gd^Es       , Gs          , Gs          , Gd          , Gs          , Gs          , Rd          , Re          , Gs^Vh       , Rr          , Rr          , Gg          , Hh          , Hh          , Hh          , Hh          , Wo          , Ww          , Wo          , Wo          
Gd          , Hhd         , Gd          , Ke          , Ce          , Gd          , Hhd         , Gd          , Gs          , Gd          , Hhd         , Hhd         , Gs          , Gd          , Hhd         , Md          , Gd          , Rd          , Rb^Gvs      , Hhd         , Md          , Hhd         , Hhd         , Hhd         , Gd          , Gd          , Gg          , Gg          , Hhd         , Rd          , Rd          , Gd^Dr       , Gd          , Gd          , Gs^Es       , Gd          , Gs          , Gs          , Gd          , Rd          , Gg          , Rr          , Rr          , Gg          , Gg          , Hh          , Ww          , Ww          , Ww          , Wo          , Wo          , Wo          
Gd          , Gd          , Hhd         , Ce          , Gd          , Hhd         , Gd          , Gs          , Gd          , Gd          , Gd          , Gd          , Gd          , Gd          , Gd          , Gs          , Gs          , Gd^Vhr      , Hhd         , Hhd         , Hhd         , Md          , Md          , Hh          , Hhd         , Hhd         , Hhd         , Hhd         , Hhd         , Hhd         , Gg          , Re          , Re          , Gd          , Gd          , Gs          , Gs          , Gg          , Gs          , Gs          , Gs          , Rr          , Rr          , Gg          , Ww          , Ww          , Ww          , Ww          , Ww          , Wo          , Ww          , Ww          
Gd          , Hhd         , Gd          , Gd          , Hhd         , Hhd         , Gd          , Gd          , Gd          , Gd^Edpp     , Gs          , Gd          , Gs          , Gd          , Gd          , Gd          , Gd          , Gd          , Gd          , Gd          , Gd          , Hh          , Gd          , Gd          , Gd          , Gg          , Gg          , Hhd         , Gs          , Hhd         , Hhd         , Hhd         , Rd          , Gd          , Gd          , Gd^Es       , Gd          , Gs          , Gs          , Gg          , Gs          , Rr          , Rr          , Ww          , Wo          , Ww          , Ww          , Ww          , Ww          , Ww          , Ww          , Ww          
Gd          , Hhd         , Hhd         , Gs          , Gs          , Gd          , Gd          , Gd          , Gs          , Gd          , Gd          , Gd          , Gd          , Gd^Es       , Gd          , Gd          , Gd          , Gd          , Gd          , Gd          , Gd^Es       , Gd          , Gd          , Gd          , Hhd         , Hhd         , Hhd         , Gs          , Gs          , Hhd         , Gd          , Gd          , Gd^Edpp     , Rd          , Rd          , Gd          , Gd          , Gs          , Gs          , Gs          , Gg          , Rr          , Rr          , Hh          , Hh          , Hh          , Ww          , Ww          , Gg          , Ww          , Ww          , Ww          
Gd          , Gd          , Gd^Edpp     , Gd          , Gd          , Gd          , Gd          , Gd          , Gd          , Gd          , Gd          , Gd          , Gd^Es       , Gd          , Gd          , Gs          , Hhd         , Gd          , Gd          , Gs          , Gd          , Gs          , Gd          , Gd          , Hhd         , Md          , Hh          , Md          , Gs          , Hhd         , Gg          , Hhd^Vhhr    , Hhd         , Gd^Es       , Gd          , Re          , Re          , Gs          , Gs          , Gs          , Gg          , Rr          , Rr          , Hh          , Mm          , Hh          , Mm          , Hh          , Hh          , Gg          , Hh^Fp       , Hh          
Gd          , Hhd         , Gd          , Gd          , Hhd         , Gd          , Rd          , Gd          , Gd          , Gd^Es       , Gd          , Gd          , Gd          , Gd          , Gd          , Hhd         , Hhd         , Gs          , Gs          , Gd          , Gs          , Gd          , Hhd         , Gd          , Hhd         , Md          , Hh          , Md          , Gs          , Hhd         , Hhd         , Gs          , Hhd         , Gs          , Gs          , Gd          , Gd          , Rd          , Re          , Gg          , Gs          , Rr          , Rr          , Hh^Vhh      , Mm          , Mm          , Mm          , Mm          , Mm          , Mm          , Mm          , Mm          
Gd          , Gd          , Hhd         , Gd          , Hhd         , Gd^Vhr      , Gd          , Gd          , Gd          , Gd          , Gs          , Gd          , Rd          , Gs          , Gd          , Gd          , Rd          , Gd^Vhr      , Hhd         , Gd          , Gd          , Gs          , Hhd         , Gs          , Hhd         , Hhd         , Mm          , Md          , Hhd         , Gd          , Hhd         , Gs          , Gs          , Gs          , Gs          , Gg          , Gd          , Gs          , Gs          , Re          , Re          , Rp          , Rr          , Ch          , Mm          , Mm          , Hh          , Md          , Hh          , Mm          , Mm^Xm       , Mm          
Hhd         , Hhd         , Hhd         , Hhd         , Md          , Hhd         , Hhd         , Gd          , Gd          , Gd          , Gd          , Gd          , Gd          , Rd^Edp      , Gd          , Gs          , Hhd         , Gd          , Gd          , Hhd         , Hhd         , Gd          , Gd^Es       , Hhd         , Hhd         , Mm          , Hh          , Hhd         , Gd^Es       , Hhd         , Hhd         , Gs          , Hhd         , Gg          , Hhd         , Gs          , Gs          , Gg          , Gg          , Gs          , Gs          , Rr          , Rr          , Rr          , Rr          , Mm          , Rp          , Gg          , Rp          , Gs          , Kh          , Rp          
Hhd         , Gd          , Md          , Md          , Md          , Md          , Gd          , Gs          , Gs          , Gs          , Gd          , Gd          , Gd          , Gd          , Gd          , Gd          , Gd          , Gd          , Gs          , Gd          , Hhd         , Gd          , Gd          , Gd          , Hhd         , Mm          , Mm          , Gd          , Gd^Es       , Gd          , Hh          , Hhd         , Hhd         , Hhd         , Gg          , Hhd         , Gs          , Gd          , Gd^Dr       , Gs          , Gs          , Gg          , Gs          , Rr          , Rr          , Rr          , Rr          , Rr          , Rr          , Ch          , Ch          , Ch          
Md          , Mm          , Md          , Md          , Md          , Md          , Hhd         , Hhd         , Hhd         , Hhd         , Hhd         , Gd          , Gs          , Gd          , Gs          , Gd          , Gd          , Gd          , Gd          , Gd          , Gd          , Gd          , Gs          , Hhd         , Rd          , Hhd         , Hhd         , Md          , Md          , Gd          , Md          , Hhd         , Hhd         , Hhd         , Gg          , Gg          , Gd          , Gs          , Gs          , Gs          , Gs          , Gs          , Re          , Re          , Gs          , Rp          , Gs          , Rr          , Rr          , Rr          , Rr          , Rp          
Md          , Md          , Md          , Md          , Hhd         , Hhd         , Gd          , Gd          , Gd          , Gd          , Gd          , Gd          , Gd^Es       , Gd          , Gd          , Gd          , Rd          , Gd          , Gs          , Hhd         , Gd          , Gd          , Gd^Es       , Gs^Vh       , Rd          , Gd          , Gd          , Hh          , Hhd         , Hhd^Vhhr    , Md          , Md          , Hhd         , Hhd         , Hh          , Gg          , Hhd         , Gd          , Gd          , Gs          , Re          , Re          , Gs          , Gg          , Gs          , Gs          , Gg          , Gg          , Gs^Vh       , Rr          , Ch          , Rr          
Mm          , Md          , Mm          , Hhd         , Gd^Es       , Gd^Es       , Gd          , Gd          , Gd          , Gd          , Gd          , Gs          , Gd          , Gd          , Gd          , Rd          , Rd^Edpp     , Rd^Es       , Gd          , Gd          , Gd          , Gd          , Gd          , Rd          , Gd          , Hhd         , Gd          , Hhd         , Hhd         , Md          , Gs          , Hhd         , Gd          , Hh          , Gd          , Gd          , Gd^Edpp     , Hhd         , Re          , Re          , Gs          , Gs          , Hh          , Hh          , Hh          , Gg          , Gg          , Gg          , Hh          , Hh          , Gg          , Gs          
Mm          , Mm          , Hhd         , Hhd         , Hhd         , Gs          , Gd          , Hhd         , Gd          , Gd^Es       , Gd          , Gd          , Gd          , Gs          , Gd          , Rd          , Rd          , Rd^Gvs      , Gd          , Gd          , Gd          , Gd^Es       , Gd          , Gs          , Gd          , Hhd         , Hhd         , Md          , Md          , Gg          , Gs          , Gd          , Gd^Es       , Gd          , Hh          , Gd          , Rd          , Re          , Hh          , Hh          , Gg          , Hh          , Gs          , Hh          , Hh          , Hh          , Hh          , Mm          , Mm          , Mm          , Hh          , Gg          
Mm^Xm       , Hhd         , Hhd         , Hhd         , Gd          , Gd          , Hhd         , Hhd         , Gd          , Gd          , Gs          , Gd          , Gd          , Gd          , Gd          , Gd^Vhr      , Gd          , Gd          , Gd          , Gd          , Gd          , Gd          , Gd          , Gd          , Gd          , Gd          , Hhd         , Md          , Gd          , Gs          , Gs          , Gg          , Hh          , Gd          , Gs          , Rd          , Hh          , Hh          , Hh          , Hh          , Hh          , Hh          , Rb^Gvs      , Hh          , Gg          , Hh          , Mm          , Mm          , Mm          , Hh          , Gs          , Gs          
Hh          , Md          , Md^Xm       , Hhd         , Gs          , Gs          , Hhd         , Gd^Vhr      , Rd          , Rd^Es       , Rd          , Gd          , Gd          , Gd          , Gd          , Gd          , Gd          , Gd          , Gd          , Gd^Es       , Gd          , Gd          , Gd          , Gd          , Gd          , Gd          , Gd          , Hhd         , Hhd         , Gg          , Gd^Es       , Gd          , Hh          , Gd          , Gs          , Re          , Gg          , Hh          , Hh          , Gg          , Mm          , Hh^Vhh      , Mm          , Mm          , Mm          , Mm          , Mm^Xm       , Mm^Xm       , Hh          , Hh          , Gg          , Gs          
Hh          , Mm          , Md^Xm       , Hhd         , Hhd         , Hhd         , Gd          , Gd          , Gd          , Gd          , Gs          , Gd          , Gd          , Gs          , Gd^Es       , Gd          , Gd          , Gd          , Gd          , Gs          , Gd          , Gd          , Gs          , Gs          , Gd          , Gd          , Gd          , Hhd         , Hhd         , Hhd         , Gd^Edpp     , Hh          , Hhd^Vhhr    , Hh          , Re          , Re          , Hh          , Hh          , Gg          , Mm          , Mm^Xm       , Mm          , Mm^Xm       , Mm          , Mm^Xm       , Mm^Xm       , Gg^Efm      , Mm          , Hh          , Gg          , Gs          , Gg          
Gs          , Mm          , Mm          , Md^Xm       , Md^Xm       , Hhd         , Gd          , Gd          , Gd          , Gd          , Gd          , Gd          , Gd          , Gs          , Gd          , Gd          , Gd          , Gd          , Gd          , Gd          , Gd          , Rb^Gvs      , Rb^Gvs      , Gd          , Gs          , Gd          , Gd          , Hh          , Hh          , Hh          , Gd          , Hh          , Re          , Re          , Hh          , Hh          , Mm          , Mm          , Mm^Xm       , Mm^Xm       , Mm          , Mm^Xm       , Mm          , Mm^Xm       , Mm          , Mm          , Hh          , Mm          , Hh          , Hh          , Gg          , Hh          
Gs          , Hh          , Gg          , Gs          , Mm          , Hh          , Hhd         , Gd          , Gs          , Gs          , Gs          , Gd          , Gd^Es       , Gd          , Gd          , Gd          , Gd          , Rd          , Rd          , Gd          , Gd          , Rb^Gvs      , Gd^Vhr      , Gs          , Rd          , Gd          , Gd          , Gd          , Ce          , Hhd         , Re          , Rd          , Hh          , Hh          , Mm          , Mm^Xm       , Mm^Xm       , Mm^Xm       , Md          , Mm          , Mm          , Mm          , Hh          , Mm          , Hh          , Hh          , Gg          , Hh          , Gg          , Gs          , Hh          , Hh          
Gs          , Hh          , Gs^Es       , Gs          , Md          , Mm^Xm       , Gs          , Hhd         , Gs          , Gs          , Gs          , Gd          , Gd          , Gd          , Gs          , Gd          , Gs          , Gd^Vhr      , Gd          , Gd          , Gs          , Gd          , Rd          , Rd          , Gd          , Rd          , Rd          , Rd          , Ce^Dr       , Ce          , Hh          , Hh          , Mm          , Mm          , Mm^Xm       , Mm^Xm       , Ms          , Ms          , Md          , Md          , Hh          , Hh          , Hh          , Hh          , Hh          , Gg          , Gg          , Gg          , Hh          , Hh          , Mm          , Mm          
Gs          , Gs          , Hh          , Gg          , Md          , Mm^Xm       , Hhd         , Gs          , Gs          , Gs          , Gd          , Gd          , Gs          , Gd          , Gs          , Gs          , Gd          , Gd          , Gs          , Gs          , Rd          , Rd          , Gd          , Gd          , Rb^Gvs      , Gs^Vh       , Rb^Gvs      , Gd          , Ce          , Ce          , Hh          , Mm          , Mm^Xm       , Mm^Xm       , Ms          , Ww          , Ww          , Hh          , Gg          , Hh          , Gg          , Gg          , Hh          , Gg          , Hh          , Gg          , Gs          , Hh          , Mm          , Hh          , Hh          , Ms          
Gs          , Gg          , Gs          , Mm          , Md          , Md^Xm       , Mm^Xm       , Hhd         , Gd          , Gs          , Gd          , Gd          , Gs          , Gs          , Gs          , Gd          , Gs          , Gd          , Rd          , Rd          , Gs          , Gd          , Gg          , Hhd         , Hhd         , Rb^Gvs      , Mm          , Gg          , Hh          , Hh          , Mm          , Mm^Xm       , Mm          , Ms          , Hh^Vhh      , Ww          , Gg          , Hh          , Ce          , Gg          , Gs          , Hh          , Hh          , Gg          , Hh          , Gs          , Gg          , Hh          , Mm          , Ms          , Hh          , Mm^Xm       
Rb          , Gs          , Gs          , Hh          , Hh          , Hhd         , Mm^Xm       , Gd          , Gs          , Gd          , Hhd         , Gd          , Gs          , Rd          , Gs          , Gs          , Re          , Rd          , Gd          , Gd          , Gd          , Gs          , Hhd         , Gd          , Mm          , Ww          , Mm          , Mm          , Mm          , Mm          , Mm^Xm       , Mm^Xm       , Mm          , Mm          , Ww          , Ww          , Gg          , Ce          , Ke          , Ce          , Gs          , Gg          , Gs          , Hh          , Hh          , Gg          , Gg          , Hh          , Ms          , Mm          , Mm          , Mm          
Ww          , Rb          , Rb          , Gs          , Hh          , Hhd         , Mm^Xm       , Hhd         , Gs          , Gs          , Hhd         , Gs          , Gs          , Gd^Vhr      , Re          , Rd          , Gs          , Gs          , Gs          , Gd          , Hhd         , Hhd         , Hhd         , Hh          , Hhd         , Md          , Md          , Mm          , Mm^Xm       , Mm^Xm       , Mm          , Mm          , Hh          , Gg          , Ww          , Gg          , Gg          , Gg          , Gg          , Gg          , Gg          , Gs          , Gs          , Gg          , Hh          , Gg          , Gg^Efm      , Hh^Vhh      , Ms          , Mm          , Mm^Xm       , Hhd         
Ww          , Gg          , Wwf         , Rb          , Rb          , Mm          , Mm^Xm       , Mm^Xm       , Ce          , Ce          , Ce^Dr       , Gs          , Re          , Re          , Gs          , Gs          , Gs          , Gs          , Gs          , Gg          , Hh          , Hh          , Hh          , Hhd         , Hh          , Md          , Mm          , Mm^Xm       , Mm          , Mm          , Mm          , Hh          , Ww          , Ww          , Gg          , Gg          , Gs          , Hh          , Gs          , Gg          , Hh          , Gg          , Gg          , Gg          , Hh          , Hh          , Hh          , Ms          , Mm          , Mm          , Md          , Hhd         
Gg          , Ww          , Ww          , Ww          , Wo          , Rb          , Rb          , Hh          , Hhd         , Ce          , Re          , Re          , Gs          , Gs          , Gs          , Gs          , Gs          , Gs          , Hh          , Hhd         , Md          , Md          , Hh          , Hhd         , Gg^Efm      , Mm          , Mm          , Mm^Xm       , Mm          , Mm          , Ww          , Ww          , Gg          , Gg          , Gg          , Gs          , Gs          , Hh          , Gs          , Gs          , Gg          , Hh          , Hh          , Hh          , Md          , Hh          , Ms          , Ms          , Mm^Xm       , Md          , Hhd         , Hhd         
Gg          , Gg          , Gs          , Gg          , Hh          , Wo          , Ww          , Rb          , Rb          , Rb          , Gg          , Gg          , Gg          , Gg          , Gg          , Gs          , Gg          , Gg          , Gg          , Hh          , Md          , Hhd         , Mm          , Md          , Md          , Mm          , Mm^Xm       , Mm^Xm       , Hh          , Ww          , Gg          , Gg          , Gg          , Gg          , Hh          , Gs          , Hh          , Hh          , Hh          , Gg          , Gg          , Md          , Hh          , Md          , Ms          , Md          , Mm^Xm       , Mm^Xm       , Mm          , Md          , Hhd         , Gg          
Gg          , Gg          , Hh          , Hh          , Mm^Xm       , Mm^Xm       , Hh          , Wo          , Ww          , Gg          , Ww          , Gg          , Ww          , Ww          , Ww          , Ww          , Ww          , Gg          , Gg^Efm      , Hh          , Mm          , Hhd         , Hh          , Md          , Md          , Mm^Xm       , Mm^Xm       , Hh          , Wo          , Ww          , Gg          , Gg          , Hh          , Hh          , Mm          , Hh          , Mm          , Hh          , Hh          , Hh          , Mm          , Hh          , Mm          , Hh          , Mm          , Mm^Xm       , Mm^Xm       , Mm          , Md          , Mm          , Hhd         , Gg          
Gg          , Hh          , Mm^Xm       , Mm^Xm       , Mm          , Hh          , Hh          , Hh          , Gg          , Ww          , Ww          , Ww          , Ww          , Ww          , Ww          , Ww          , Ww          , Ww          , Ww          , Hh          , Hh          , Mm          , Mm          , Mm          , Mm^Xm       , Mm^Xm       , Hh          , Hh          , Ww          , Gg          , Gg          , Gg          , Hh          , Mm          , Mm          , Hh          , Mm          , Mm          , Mm          , Mm          , Mm          , Mm          , Mm          , Mm          , Mm          , Mm          , Mm          , Md          , Mm          , Md          , Hhd         , Gd          
Mm^Xm       , Mm          , Mm          , Mm          , Gs          , Gs          , Hh          , Gs          , Gs          , Gg          , Ss          , Ww          , Gg          , Gg          , Gg          , Ww          , Gg          , Ww          , Ww          , Ww          , Hh          , Hh          , Hh          , Mm          , Mm^Xm       , Hh          , Hh          , Hh          , Ww          , Gg          , Hh          , Hh          , Mm          , Mm          , Mm          , Mm          , Hh          , Mm          , Mm          , Mm          , Ms          , Mm          , Ms          , Mm          , Mm^Xm       , Mm^Xm       , Mm          , Mm          , Hhd         , Hhd         , Gd          , Gd          
Md          , Hh          , Gs          , Mm          , Gs          , Hh          , Hh          , Gs          , Gs          , Gs          , Gs          , Ss          , Gg          , Ss          , Ss          , Gg^Efm      , Ss          , Ww          , Ww          , Ww          , Ww          , Hh          , Hh          , Mm          , Mm          , Mm^Xm       , Hh          , Hh          , Wo          , Ww          , Gg          , Hh          , Mm          , Hh          , Mm          , Mm          , Hh          , Mm          , Ms          , Ms          , Mm^Xm       , Ms          , Mm^Xm       , Mm^Xm       , Mm          , Mm          , Md          , Md          , Hhd         , Hhd         , Gs          , Gs          
Mm          , Mm          , Hh          , Hh          , Gs          , Gs          , Gs          , Gs          , Gs          , Gs^Es       , Gs          , Gs          , Gs          , Gs          , Ss          , Gg          , Gg^Em       , Hh          , Ww          , Ww          , Gg          , Ww          , Hh          , Mm          , Mm          , Mm^Xm       , Hh          , Gg^Efm      , Ss          , Wo          , Gg          , Hh          , Mm          , Mm          , Mm          , Hh          , Mm          , Wo          , Ms          , Mm^Xm       , Ms          , Mm          , Mm          , Mm          , Md          , Md          , Hhd         , Gd          , Gd          , Gd          , Gs          , Gd          
Hh          , Hh          , Gs          , Gs          , Gs          , Gs          , Gs          , Gs          , Gs          , Gs          , Gs          , Ss          , Ss          , Gs          , Ss          , Gs          , Gg          , Ss          , Gg          , Ww          , Ss          , Ww          , Gg          , Hh          , Mm          , Mm^Xm       , Mm^Xm       , Hh          , Ww          , Ww          , Gg          , Gg          , Mm          , Mm          , Mm          , Mm          , Ms          , Ms          , Ms          , Mm^Xm       , Ms          , Ms          , Ms          , Mm          , Mm          , Mm          , Gd          , Gd          , Gd          , Gd          , Gd          , Gs          
