border_size=1
usage=map

Md, Md, Gg^Es, Gg^Es, Gg^Efm, Hh, Md, Md, Ms^Xm, Md, Hh, Hh, Hh, Md, Hh^Fp, Hh^Fp, Gg, Gg^Efm, Ss, Ww, Gg^Efm, Ww, Ww, Gg, Ds, Ss, Ds, Sm, Ss, Ds, Ww, Gg, Ss, Hh^Fds, Mm, Mm, Ms^Xm, Ms, Mm, Mm, Ms, Ms^Xm, Hh^Fp, Hh^Fp, Mm, Mm, Mm, Mm, Mm, Hh^Fp, Mm, Mm, Hh, Mm^Xm, Hh, Hh^Fp, Hh^Fp, Hh^Fp, Hh, Mm, Mm, Hh, Hhd, Hhd^Fdw, Hhd, Hhd, Hhd, Gd^Es, Gs^Edpp, Gd^Es, Gs
Md, Md, Ww, Gg, Hh, Md, Md, Ms^Xm, Md, Md, Hh^Fp, Md, Md, Md, Hh, Hh, Gg, Gg^Efm, Gg^Efm, Ss, Gg^Efm, Ww, Ww, Gg, Ss, Ss, Ss, Sm, Ss, Ss, Wwf, Gg^Efm, Ss, Hh^Fp, Hh, Mm, Mm, Ms^Xm, Ms^Xm, Mm, Ms, Ms, Mm, Mm, Mm, Mm, Mm, Mm, Mm, Mm, Mm, Mm, Mm, Mm^Xm, Hh^Fp, Hh, Hh, Hh, Gs, Gs, Gs, Hh, Gs^Es, Hhd^Fdw, Hhd, Hhd, Hhd, Gs^Es, Gs, Gs, Gs
Ms, Ms, Hh, Hh, Md, Md, Ms^Xm, Ms^Xm, Ms, Md, Md, Md, Hh^Vhh, Hh, Hh, Gs, Gs, Gg, Gg, Gg^Efm, Sm, Ds, Ds, Ww, Ww, Ss, Ds, Ss, Gg, Ww, Wot, Ss, Gg, Gg^Efm, Gg, Hh, Gs^Es, Mm, Mm, Ms^Xm, Ms^Xm, Ms, Mm, Mm^Xm, Hh^Fp, Mm, Mm^Xm, Mm, Mm^Xm, Ms^Xm, Mm^Xm, Mm, Mm^Xm, Mm^Xm, Mm, Hh, Hh, Hh, Hhd, Gd, Gs, Gs, Gd^Es, Gs, Gs, Hhd, Gs^Es, Gd, Gs^Es, Gs, Gs
Ms, Md, Md, Hh, Mm, Ms^Xm, Ms^Xm, Ms, Ms, Md, Hh, Hh^Fp, Hh, Hh, Gg, Gs, Gg, Gg, Gg, Ds, Ss, Ss, Ww, Ww, Ds, Ww, Ww, Ww, Gg^Efm, Wwg, Hh^Vhh, Hh, Hh, Gg, Gg^Efm, Gs, Hh, Hh, Mm, Ms^Xm, Ms, Ms, Mm, Mm^Xm, Ww, Ms^Xm, Mm, Mm^Xm, Mm, Mm, Mm, Mm, Mm^Xm, Mm, Mm, Mm, Mm, Hh, Gs, Gd, Gd^Edpp, Gs, Gs, Gd^Edpp, Gs, Gs, Gd^Es, Gd^Dr, Gs^Es, Gs, Gs
Ms^Xm, Md, Md, Mm, Mm, Mm, Mm, Ms^Xm, Ms^Xm, Ww, Ww, Hh, Ww, Gg^Efm, Gg^Efm, Gg^Efm, Ss, Gg^Efm, Ww, Ss, Ww, Ww, Ds, Ds, Ss, Ss, Ds, Ww, Wwf, Wot, Ss, Mm, Hh, Gg^Efm, Gg, Gs^Es, Hh, Hh, Mm^Xm, Ms^Xm, Ms, Ms, Mm, Mm^Xm, Ms^Xm, Ms^Xm, Mm, Mm, Mm^Xm, Mm, Mm^Xm, Ms^Xm, Mm, Mm, Hh^Vhh, Hh^Fp, Hh, Gs, Gd, Gs, Gd^Es, Gs, Gd, Gd, Gs, Gs^Edp, Gs, Gd^Es, Gs^Es, Gs, Gs
Hh^Fp, Ms^Xm, Ms^Xm, Mm, Mm, Mm, Mm, Ms^Xm, Ms^Xm, Mm, Mm, Ww, Gg^Efm, Ww, Ww, Ww, Ww, Ww, Ds, Ww, Sm, Ss, Ss, Ss, Ds, Sm, Ss, Gg, Wot, Wot, Hh, Hh^Fds, Mm, Hh, Gg, Gs, Mm, Mm, Mm^Xm, Mm^Xm, Mm, Mm, Mm, Ms^Xm, Mm, Mm, Mm, Mm, Hh, Mm^Xm, Mm, Ms^Xm, Mm^Xm, Mm, Mm, Hh, Hh, Gd, Gs, Gd, Gs, Gd^Es, Gs, Gd^Edpp, Gd, Gs, Gs^Es, Gs^Es, Gs, Gs, Gs
Hh^Fp, Md, Ms^Xm, Hh^Fp, Hh^Vhh, Hh^Fp, Hh, Mm, Mm, Ms, Mm, Hh, Gg, Ds, Hh, Hh, Ss, Ss, Ss, Ss, Ds, Sm, Ss, Ss, Ss, Ss, Ss, Gg, Ss, Wot, Ss, Mm, Mm, Hh, Gg, Hh, Hh, Mm, Mm^Xm, Mm^Xm, Ms^Xm, Mm, Mm, Mm^Xm, Ms^Xm, Mm, Hh, Hh, Hh, Hh, Hh, Mm, Mm^Xm, Mm, Mm, Hh, Hh, Gs, Gs, Mm, Gd, Gs, Gs^Es, Gd, Gs, Gs, Gg, Gs^Es, Gs, Gs, Gs
Md, Md, Ms^Xm, Ms^Xm, Hh, Hh^Fp, Hh, Mm, Mm, Ms, Mm, Hh, Gg, Ds, Ss, Ss, Ds, Gg^Efm, Ss, Gg, Rb, Ss, Ds, Gg, Ss, Ds, Gg, Ss, Wot, Wot, Hh^Fds, Hh^Fds, Mm, Gg, Gg^Efm, Hh, Gg, Gg, Mm, Ms^Xm, Mm^Xm, Mm, Hh^Fp, Wo, Ms^Xm, Mm, Gg, Gg, Hh, Hh^Fp, Mm, Mm, Mm, Wo, Mm, Mm, Mm, Hh, Hh, Gs, Hh, Gd, Gs, Gd, Gs^Es, Gs, Gd, Gs, Gs, Gs, Gs
Ms^Xm, Md, Ms^Xm, Md, Hh, Gg^Efm, Gg^Efm, Gg^Efm, Mm, Mm, Hh, Hh, Ss, Gg, Gg, Ds, Rb, Re, Gg, Rb, Gg, Ss, Gg, Rb, Gg, Rb, Re, Gg, Wot, Wot, Hh, Mm, Hh, Gg, Gg, Gs, Hh, Hh, Hh^Vhh, Mm^Xm, Mm^Xm, Ms^Xm, Mm^Xm, Ms^Xm, Mm, Mm, Gg, Gg, Gg, Hh, Mm, Mm, Ms^Xm, Wo, Ha^Fda, Mm, Mm, Mm, Mm, Hh, Hh, Hh, Gs, Gs, Gd, Gd^Es, Gd, Gg, Rrc, Gg, Rrc
Md, Ms^Xm, Hh^Fp, Gg^Efm, Gs, Gg, Gs, Mm, Mm, Mm, Hh, Ss, Gg, Ds, Rb, Ss, Ss, Ds, Ds, Ss, Ss, Gg^Efm, Ds, Ds, Ww, Ss, Gg^Efm, Rb, Wot^Bw\, Wot, Hh, Hh, Gs, Gs, Gs, Gs^Es, Gs, Hh, Hh, Mm, Ms, Ms^Xm, Mm^Xm, Mm, Hh^Vhh, Mm, Gs, Gs, Hh, Mm, Mm, Mm, Mm^Xm, Ms, Ms, Mm, Mm, Mm, Mm, Mm, Hh, Gs, Gs^Es, Gs, Gs, Gs, Rr, Rrc, Gs, Rrc, Gg
Wo, Md, Hh, Hh, Gg, Gg^Es, Gs, Hh, Mm, Mm, Hh, Gg, Rb, Rb, Ds, Ss, Ww, Ww, Ww, Ww, Wot, Ds, Ww, Ww, Wot, Ww, Wot, Wot, Wot, Wot^Bw\, Rb, Rb, Rb, Gs, Gs, Gs, Gs^Es, Hh, Hh, Mm, Ms, Ms, Mm^Xm, Mm, Hh, Hh, Khr, Hh, Hh^Vhh, Hh, Mm, Mm^Xm, Mm, Ms^Xm, Mm^Xm, Mm, Mm, Mm, Mm, Mm, Hh, Gs, Gs, Gd, Rrc, Rrc, Gs, Gd, Gs^Es, Gs, Gs
Md, Md, Hh, Hh, Gs^Es, Gs, Gg, Hh, Mm, Hh, Gg, Gg, Rb, Gg, Ds, Ss, Ww, Wot, Wot, Wot, Wot, Wot, Wot, Wot, Hh, Wot, Wot, Wot, Ww, Hh, Mm, Gg, Gg^Efm, Ss, Rb, Gg, Gg, Gs, Ww, Ww, Mm, Ms, Mm^Xm, Mm, Mm, Chr, Chr, Chr, Gg^Efm, Mm, Mm, Mm, Mm, Mm, Mm, Mm^Xm, Mm^Xm, Mm, Mm, Mm, Gs, Gs, Rp, Rp, Gs, Gs, Gs^Wm, Gs, Gd, Gd, Gs
Md, Md, Md, Gs, Gg, Gs, Gg, Gg, Gg, Gg, Re, Rb, Gg, Gg, Ss, Ss, Wot, Wot, Hh, Ss, Mm, Mm, Mm, Mm, Md, Ss, Ss, Ww, Hh, Ww, Ww, Ww, Ww, Ss, Gs, Rb, Ww, Ww, Mm, Mm, Mm, Mm^Xm, Mm, Mm, Mm, Mm, Mm, Rp, Hh, Mm, Mm, Mm, Mm, Mm, Mm, Mm, Mm^Xm, Mm^Xm, Hh, Hh, Rr, Rr, Gd, Gs, Gs, Gg, Gs, Gs, Gd, Gs^Wm, Gs
Hh, Md, Hh, Gg, Gg, Gg, Gs, Gs, Rb, Gs, Gg^Es, Gg, Ss, Gg, Gg^Efm, Wot, Wot, Wot, Wot, Ss, Mm, Mm, Mm, Ms^Xm, Ms^Xm, Md, Mm, Ss, Mm, Mm, Mm, Mm, Ww, Ww, Ww, Ww, Sm, Ww, Mm, Mm, Mm^Xm, Mm^Xm, Mm^Xm, Mm, Hh, Mm, Gs, Rp, Gs^Es, Hh, Gs, Gs, Mm, Mm, Mm, Mm, Mm^Xm, Mm, Rr, Rr, Gs, Gg, Gg, Gs, Gs^Es, Gs, Gs^Edpp, Gd, Gs, Gs, Gs
Gg, Hh, Gs, Gs, Gs, Gg, Rb, 1 Re, Gg, Gg, Ss, Ss, Gg^Efm, Gg, Ww, Wwf, Wot, Wot, Gg^Efm, Hh, Mm, Mm, Mm, Hh^Fms, Mm, Mm, Mm, Mm, Mm, Mm, Mm, Hh, Ms^Xm, Mm, Ww, Ss, Re, Gs, Mm, Mm^Xm, Hh, Mm, Hh, Hh, Gs, Re, Re, Re, Gs, Gs, Gs, Hh, Hh, Mm, Mm, Mm^Xm, Hh, Rp, Mm, Hh, Hh, Gg, Gs, Gs, Gs, Gs, Gg, Gs^Es, Gs, Gs^Wm, Gg^Efm
Gg, Gs, Gs, Gs^Es, Gs, Gg, Gg, Gg, Gg, Gg, Ss, Ds, Gg, Gg, Ww, Wot, Ss, Wwf, Gg, Hh, Ss, Mm, Hh^Fp, Mm, Mm, Mm, Mm, Mm, Mm, Mm, Mm, Mm, Mm, Ms^Xm, Ms^Xm, Mm, Re, Hh, Hh, Mm^Xm, Hh^Vhh, Hh, Re, Re, Gs, Hh, Hh, Re, Re, Mm, Gs, Gs^Es, Gs, Hh^Vhh, Mm, Mm^Xm, Re, Re, Mm, Mm, Hh, Gs, Gs, Gs^Es, Gs, Gs, Gg^Efm, Gd, Gg, Gg^Efm, Gg^Eff
Gg, Gs, Re, Re, Gg, Gg, Gg, Gs, Gg, Ss, Gg, Ss, Gg^Efm, Ww, Wot, Wot, Ww, Ww, Hh, Hh, Ww, Ss, Gg^Efm, Hh, Hh^Efm, Mm, Hh^Fp, Mm, Md, Md, Ms^Xm, Mm, Mm, Mm, Mm, Mm, Gs, Re, Gs, Hh, Hh, Gs, Hh, Hh, Hh, Mm, Mm, Gs, Hh, Rp, Mm, Re, Rp, Mm, Mm, Hh, Rr, Mm, Mm^Xm, Hh, Hh, Hh, Hh, Gs, Gs, Gs, Gg^Efm, Gg, Gg^Eff, Gg^Eff, Rb^Gvs
Re, Re, Gs, Gg, Gs, Gg^Efm, Ss, Gg, Ss, Gg, Ds, Ds, Wot, Wot, Ww, Ss, Gg^Efm, Ww, Wwf, Wwf, Hh, Ww, Wwf, Hh, Ww, Wwf, Wwf, Hh^Vhh, Mm, Ms^Xm, Mm, Mm, Mm, Mm, Mm, Mm, Gg^Efm, Gs, Gs, Gs, Re, Re, Gg^Efm, Mm, Gs, Mm, Mm, Gs, Hh, Mm, Mm, Mm, Mm, Re, Re, Rp, Mm, Mm^Xm, Mm, Mm, Hh^Vhh, Hh, Hh, Hh, Gs, Gg, Gg^Eff, Gg^Eff, Rb^Gvs, Rb^Gvs, Rb^Gvs
Gg, Gg, Gg, Gs^Es, Gg, Ds, Ss, Gg, Ss, Gg^Efm, Ww, Ww, Wot, Wot, Ds, Ss, Mm, Hh, Mm, Gg^Efm, Hh^Vhh, Hh, Hh^Fp, Ww, Mm, Mm, Mm, Mm, Ms^Xm, Ms^Xm, Md, Hh, Hh, Mm, Mm, Mm, Gs, Gg, Gs, Gs, Gg, Gs, Gg, Gs, Gs, Gs, Gs^Es, Gs, Hh^Fp, Hh^Fp, Mm, Mm, Hh, Gs, Gs, Hh, Mm, Mm^Xm, Mm^Xm, Mm, Mm, Hh, Hh, Gs, Gg^Eff, Gg^Eff, Rb^Gvs, Rb^Gvs, Rb^Gvs, Rb^Gvs, Rb^Gvs
Gg, Gg, Ss, Gg^Efm, Ss, Ss, Ds, Ss, Ww, Ww, Ww, Wot, Wot, Gg, Hh, Mm, Mm, Mm, Ms^Xm, Mm, Mm, Mm, Mm, Mm, Md, Mm, Ms^Xm, Ms^Xm, Ww, Md, Mm, Mm, Mm, Hh, Hh, Mm, Gg^Es, Gs^Es, Gs^Es, Gs, Gs, Gs^Es, Gs, Gs, Gs, Gs, Hh, Hh, Mm, Mm, Mm, Mm, Hh, Gd, Gs, Gs^Es, Hh, Mm, Mm, Mm^Xm, Mm^Xm, Mm, Hh, Gg^Eff, Gg^Eff, Rb^Gvs, Rb^Gvs, Rb^Gvs, Rb^Gvs, Rb^Gvs, Rb^Gvs
Ss, Gg, Ss, Ss, Gg^Efm, Ds, Ww, Ww, Wot, Wot, Wot, Wot, Hh, Hh, Hh, Mm, Ms^Xm, Ms^Xm, Ms^Xm, Ms^Xm, Ms^Xm, Mm, Mm, Mm, Ms^Xm, Ms^Xm, Hh^Fp, Hh^Fp, Hh^Fp, Hh^Fp, Mm, Mm, Mm, Gg^Efm, Gg, Gg, Gs, Gg, Gs, Gs, Gg^Efm, Hh, Hh^Fp, Gs, Gg, Gg^Efm, Hh, Mm, Mm^Xm, Mm^Xm, Mm, Mm, Mm, Hh, Gs^Es, Gg, Gg^Efm, Hh, Mm^Xm, Mm^Xm, Mm^Xm, Mm, Hh, Gs, Gs, Gg^Eff, Gg^Eff, Rb^Gvs, Rb^Gvs, Rb^Gvs, Rb^Gvs
Ds, Ss, Sm, Ds, Ds, Ww, Wot, Wot, Gg^Efm, Ss, Ss, Gg, Hh, Gg, Hh, Mm, Ms, Ms, Ww, Ms, Ms, Ms, Mm^Xm, Mm^Xm, Mm, Mm, Hh, Hh^Efm, Mm, Mm, Mm, Mm, Hh, Hh, Gg, Gg, Hh, Hh, Hh, Hh, Mm, Hh^Efm, Mm, Hh, Hh, Gs, Gs, Mm, Hh, Mm, Mm, Mm, Mm, Hh, Hh, Gg, Hh, Hh, Hh^Fp, Mm, Mm^Xm, Mm, Hh, Hh, Gg, Gs, Hh, Gg^Eff, Gg^Eff, Rb^Gvs, Rb^Gvs
Ww, Sm, Gg^Efm, Ss, Ww, Ww, Wot, Wot, Ss, Ss, Gg, Ss, Gg, Gg, Gg, Hh, Ww, Ww, Hh, Ms, Mm^Xm, Mm^Xm, Mm, Mm^Xm, Mm, Mm, Hh, Hh, Mm, Ms, Mm, Mm, Gg^Efm, Gg, Hh, Gs, Hh, Gg^Efm, Mm, Mm, Mm, Mm, Mm^Xm, Mm, Mm, Hh, Gg, Gs, Hh, Mm, Mm, Mm, Mm, Hh, Gs^Es, Hh, Hh, Hh, Hh, Mm, Mm, Mm^Xm, Mm, Hh, Hh, Hh, Gg^Efm, Hh, Gs, Gg^Eff, Gg^Eff
Wot, Ww, Ww, Ww, Wot, Ww, Wot, Wot, Ww, Ww, Ww, Gg^Efm, Ww, Ww, Ww, Ww, Hh, Hh^Fp, Mm, Mm, Mm^Xm, Mm, Mm, Mm, Mm, Hh^Fp, Gg^Emf, Mm, Mm, Mm, Mm, Hh, Gg, Gs^Es, Gg, Hh, Mm, Mm, Hh, Mm, Mm^Xm, Mm^Xm, Hh, Mm, Mm, Hh, Hh, Gg, Hh, Mm, Mm, Mm^Xm, Hh, Hh, Gg, Gg, Gs^Es, Hh, Hh, Mm, Mm, Mm^Xm, Mm^Xm, Mm, Mm, Mm, Mm, Gg, Hh, Hh, Gs
Wot, Ww, Wot, Ww, Wot, Wot, Wot, Wot, Gg^Efm, Gg, Hh, Ww, Gg^Efm, Gg, Hh, Hh, Mm, Mm, Mm^Xm, Mm^Xm, Mm, Mm, Mm, Mm, Hh, Gg, Hh, Hh, Mm, Mm, Hh, Hh, Gs, Gs, Hh, Mm, Mm, Mm, Mm, Hh^Fp, Mm^Xm, Mm, Mm^Xm, Mm, Mm, Mm, Hh, Gg, Gg, Hh, Mm, Mm, Hh, Gg^Efm, Gg, Gs, Gg, Gg, Hh, Mm, Mm, Mm, Mm^Xm, Mm^Xm, Mm, Mm, Mm, Mm, Hh, Hh, Gg
Gg, Wot, Wot, Wot, Ss, Wot, Gg, Ss, Hh, Hh^Efm, Hh^Efm, Gg, Hh^Fp, Hh, Mm, Mm, Mm, Mm, Mm^Xm, Mm, Mm, Mm, Hh, Hh, Gg, Gg^Efm, Hh, Mm, Hhd^Fdw, Hh, Gs, Gs, Gg, Gg, Hh, Mm, Mm, Mm, Ms, Ms^Xm, Mm, Mm^Xm, Mm, Mm, Mm, Hh, Gs, Gg, Mm, Mm, Mm^Xm, Mm, Mm, Hh, Gs, Gs, Gg, Gg, Hh, Hh^Fp, Mm, Mm, Mm, Mm^Xm, Mm^Xm, Mm, Ww, Mm, Mm, Hh, Hh
Gg, Ss, Ss, Ss, Gg, Gg^Efm, Gg, Hh, Hh, Hh, Hh, Hh, Hh^Fp, Mm, Mm, Mm, Mm, Mm, Mm, Mm^Xm, Mm^Xm, Mm, Hh, Hh, Gg, Gg, Gg, Mm, Mm, Hhd^Fdw, Gg, Gs, Gg, Gg^Efm, Hh, Mm, Mm, Mm, Ms, Ms, Mm, Mm, Mm, Mm, Gg, Gs, Gs, Hh, Mm, Mm, Mm^Xm, Mm, Gg, Hh, Gg, Gg, Gg, Gs, Gs, Hh^Fp, Hh^Fp, Mm, Mm, Mm, Mm, Mm^Xm, Mm^Xm, Mm, Gg, Mm, Hh
