border_size=1
usage=map

Hhd, Hhd, Hhd, Hhd, Hhd, Hhd, Hhd, Hhd, Hhd, Hhd, Gs, Gg, Gs, Gs, Gg^Efm, Gg, Gg^Efm, Rrc, Rrc, Gg, Gg, Gg, Gg^Efm, Wwg, Wwg, Ww, Gg^Efm, Gg, Gg^Efm, Gg, Gg, Gs, Gs, Gs, Gs, Gg
Gs^Dr, Gd^Es, Gd^Es, Gd^Es, Gd^Es, Gd^Es, Gd^Es, Gd, Gd^Es, Gs^Es, Gs^Es, Gg^Es, Gg^Efm, Gg^Efm, Gs, Gs^Efm, Gg, Rrc, Rrc, Gg^Em, Gg, Gg^Efm, Gg, Gg^Efm, Wwg, Ww, Gg, Gg^Em, Gg^Efm, Gg^Efm, Gg, Gs, Gg, Gg, Rp, Rp
Gs, Gd^Edp, Gd^Es, Gd^Es, Gs, Gs^Es, Gs^Edpp, Gs^Es, Gs, Gs, Gs, Gg, Gs, Gg^Efm, Gg, Gg, Gg, Rrc, Rrc, Gg, Gg, Gg^Em, Gg, Gg^Efm, Gg, Wwg, Wwg, Gg, Gg^Efm, Gg, Gg, Gg, Rr, Rr, Rr, Rr
Hhd, Hhd, Gs^Es, Gs^Es, Gs, Gs^Es, Gs^Es, Gs, Gs, Gs, Ce, Gs, Ke, Gs, Ke, Gs, Ce, Rrc, Rrc, Gg, Ce, Gg, Ce, Gg, Ce, Ww, Ww, Wwg, Gg, Gg^Efm, Rr, Rr, Rr, Rr, Gg, Gg
Gs^Edpp, Gd, Gs^Es, Hhd, Gs^Es, Gs^Es, Gs, Gs, Ke, Ke, Ke, Ke, Ke, Ke, Ke, Ke, Rrc, Rrc, Rrc, Ce, Rrc, Ce, Rrc, Ce, Gg, Ce, Ce, Ww, Wwf^Bw/, Rr, Rr, Rr, Gg^Efm, Gg, Ss, Ss
Gs, Gd, Gs, Gs^Es, Gs^Es, Gs, Ke, Ke, Ke, Ke, Ke, Ke, Ke, Ke, Rrc, Rrc, Rrc, Rrc, Rrc, Rrc, Rrc, Rrc, Rrc, Rr, Rr, Gg, Rr, Rr, Rr, Wwf^Bw/, Wwf, Gg, Gg, Gg^Em, Ss, Gg
Hhd, Gd^Es, Gs^Edpp, Gd^Es, Gs, Ce, Ke, Ke, Ce, Ke, Ke, Ke, Rrc, Rrc, Rrc, Rrc, Rrc, Rrc, Rrc, Rrc, Rrc, Rrc, Rrc, Rr, Rr, Rrc, Rrc, Rr, Ce, Wwf, Wwg, Ww, Sm, Gg^Em, Ss, Ss
Hhd, Gs^Es, Gs, Gs, Gs, Ke, Ke, Ce, 2 Ke, Ce, Rrc, Rrc, Rrc, Rrc, Rrc, Rrc, Rrc, Rrc, Rrc, Rr, Rr, Rrc, Rrc, Rrc, Rr, Rrc, Rrc, Rp, Ss, Ce, Ce, Wwg, Wwg, Sm, Gg^Efm, Ss
Gs^Es, Gd, Gs^Es, Gs, Gs, Ke, Ke, Ce, Rrc, Rrc, Rrc, Rrc, Rrc, Rrc, Rrc, Rrc, Rrc, Rrc, Rrc, Rr, Rrc, Rr, Rr, Rr, Rr, Rrc, Rr, Rb, Rd, Sm, Ce, Ww, Wwg, Ss, Ss, Gg
Gd^Es, Gd^Dr, Gs^Es, Gs, Gs, Ce, Rrc, Rrc, Rrc, Rrc, Rrc, Rrc, Rrc, Rrc, Rrc, Rrc, Rrc, Rrc, Rr, Rr, Rr, Rr, Rp, Rr, Rr, Rp, Rd, Rd, Rp, Sm, Ce, Ww, Ww, Wwg, Ss, Gg
Gs, Gd^Es, Gs^Es, Gs, Gs, Ce, Rrc, Rrc, Rrc, Rrc, Rrc, Rrc, Rrc, Rrc, Gs, Rrc, Rrc, Rrc, Rrc, Rr, Rr, Rr, Rr, Rp, Rp, Rp, 3 Rd, Rp, Rp, Sm, Ss, Ce, Ww, Wwg, Ss, Ss
Gs^Es, Gs^Es, Gs, Gs, Gs, Ce, Rrc, Rrc, Rrc, Rrc, Rrc, Rrc, Rrc, Gs, Gs, Gg, Gg^Fet, Rrc, Rrc, Rr, Rr, Rr, Rr, Rr, Rp, Rd, Rr, Rp, Rb, Rb, Gg, Ce, Ww, Ww, Ss, Ss
Gg, Gs^Es, Gs, Gs, Gs, Ce, Rrc, Rrc, Rrc, Rrc, Rrc, Rrc, Rrc, Gs, Gg, Wot, Gg, Rrc, Rr, Rr, Rr, Rr, Rp, Rr, Rd, Rr, Rr, Rp, Rp, Rb, Sm, Ce, Ww, Ww, Ss, Ss
Gd, Gs, Gs, Gs, Gs, Ce, Rrc, Rrc, Rrc, Rrc, Rrc, Rrc, Rrc, Gg, Gg, Gg, Rrc, Rrc, Re, Rp, Rr, Rp, Rp, Rr, Rd, Rd, Rr, Rp, Rp, Rp, Sm, Ce, Ww, Wwg, Ww, Ww
Gd, Gg, Rrc, Gg, Rrc, Ce, Rrc, Rrc, Rrc, Rrc, Rrc, Rrc, Rr, Rrc, Rrc, Rrc, Rr, Rrc, Rr, Rr, Rr, Rr, Rp, Rp, Rd, Rr, Rr, Rp, Rp, Rp, Ce, Ce, Ww, Ww, Ss, Ss
Rr, Rrc, Gs, 1 Rrc, Gg, Rrc, Rr, Rrc, Rr, Rrc, Rrc, Rrc, Rr, Rrc, Rr, Rr, Rr, Rr, Rr, Rr, Rr, Rr, Rd, Rp, Rd, Rd, Rd, Gll, Rp, Gg, Ce, Ww, Wwg, Wwg, Ss, Sm
Gs, Gd, Gs^Es, Gs, Gs, Ce, Re, Rr, Rr, Rr, Rr, Rr, Rr, Re, Re, Rr, Re, Rr, Rr, Rp, Rr, Rp, Rr, Rr, Rr, Rrc, Rd, Rd, Rb, Ce, Ww, Ww, Wwf, Ss, Sm, Ss
Gs^Wm, Gs, Gd, Gd, Gs, Ce, Ce, Rr, Rp, Re, Rp, Rp, Rp, Rp, Re, Rr, Rr, Rr, Rp, Rr, Rp, Re, Rp, Rr, Rd, Rrc, Re, Gll, Ce, Ce, Ww, Wwg, Ss, Sm, Wwf, Ss
Gs, Gs, Gd, Gs^Wm, Gs, Gg, Ce, Rr, Rr, Re, Rp, Rp, Re, Rd, Rr, Rr, Rp, Rp, Rp, Re, Rp, Re, Re, Re, Rp, Re, Re, Rb, Ce, Ww, Wwg, Sm, Ss, Sm, Sm, Sm
Gs^Edpp, Gd, Gs, Gs, Gs, Gs, Gs, Ce, Re, Re, Rb, Rp, Rd, Re, Rp, Rp, Rp, Rp, Rp, Re, Re, Re, Re, Rp, Re, Re, Re, Rb, Ce, Ww, Sm, Sm, Ss, Wwf, Sm^Em, Sm
Gg, Gs^Es, Gs, Gs^Wm, Gg^Efm, Gs, Gs^Eff, Ce, Re, Rp, Re, Re, Re, Re, Re, Rp, Re, Re, Re, Re, Re, Re, Re, Re, Re, Re, Re, Re, Wwg^Bw\, Wwg, Ss, Ss, Gg, Ss, Ss, Sm
Gg^Efm, Gd, Gg, Gg^Efm, Gg^Eff, Gg^Eff, Rb^Gvs, Ce, Ce, Rb, Rb, Re, Re, Rb, Re, Rp, Rb, Re, Rb, Rb, Rb, Re, Re, Re, Rb, Re, Ce, Re, Wwg^Bw\, Wwg^Bw\, Rb, Gg^Efm, Ss, Ss, Ss, Ss
Gg^Efm, Gg, Gg^Eff, Gg^Eff, Rb^Gvs, Rb^Gvs, Rb^Gvs, Rb^Gvs, Rb^Gvs, Ce, Ce, Re, Rb, Re, Rb, Re, Rb, Rb, Rb, Rb, Rb, Rb, Gg, Sm, Ce, Ce, Ww, Ww, Wwg, Rb, Rb, Rb, Rb, Ss, Ss, Gg^Em
Gg^Eff, Gg^Eff, Rb^Gvs, Rb^Gvs, Rb^Gvs, Rb^Gvs, Rb^Gvs, Rb^Gvs, Rb^Gvs, Rb^Gvs, Rb^Gvs, Rb, Ce, Rb, Ce, Rb, Ce, Rb, Ce, Rb, Ce, Ce, Ce, Ce, Ss, Ss, Wwg, Wwg, Gg^Efm, Ss, Ss, Rb, Rb, Rb, Rb, Gg
Rb^Gvs, Rb^Gvs, Rb^Gvs, Rb^Gvs, Rb^Gvs, Rb^Gvs, Rb^Gvs, Rb^Gvs, Rb^Gvs, Rb^Gvs, Rb, Rb, Rb^Gvs, Ce, Rb^Gvs, Ce, Rb^Gvs, Ce, Rb^Gvs, Ce, Rb^Gvs, Rb^Emf, Rb^Emf, Sm, Wwg, Wwg, Ww, Gg^Efm, Gg^Em, Gg^Efm, Ss, Gg, Gg^Efm, Rb, Rb, Rb
Rb^Gvs, Rb^Gvs, Rb^Gvs, Rb^Gvs, Rb^Gvs, Rb^Gvs, Rb^Gvs, Rb^Gvs, Rb^Gvs, Rb^Gvs, Rb, Rb^Gvs, Rb^Gvs, Rb^Gvs, Rb^Gvs, Rb^Gvs, Rb^Gvs, Rb^Gvs, Rb^Gvs, Rb^Gvs, Rb^Gvs, Rb^Gvs, Rb^Gvs, Wwg, Ww, Ww, Gg^Efm, Gg, Ss, Gg^Efm, Sm, Ss, Ss, Ss, Sm, Rb
Gg^Eff, Rb^Gvs, Rb^Gvs, Rb^Gvs, Rb^Gvs, Rb^Gvs, Rb^Gvs, Rb^Gvs, Rb, Rb, Rb^Gvs, Rb^Gvs, Rb^Gvs, Rb^Gvs, Rb^Gvs, Rb^Gvs, Rb^Gvs, Rb^Gvs, Rb^Gvs, Rb^Gvs, Rb^Gvs, Rb^Gvs, Wwg, Ww, Ww, Gg^Efm, Gg^Efm, Gg, Ss, Gg, Sm, Sm, Ss, Ss, Gg, Sm
