border_size=1
usage=map

Gs, Md, Md, Hh, Md, Gs, Md, Gs, Hhd, Gs, Gd, Rd, Re, Gs, Gs, Hhd, Hhd, Gd, Gs, Hhd, Hh, Gg, Gg, Gg, Ss, Ss, Gg, Ss, Ss, Ss, Ss, Ww, Wot, Ww, Ss, Wwf, Ss, Ss, Gg, Gg, Ss, Gg, Ss, Ss, Gg, Gg, Gg, Gg, Ss, Ss, Gg, Gg, Gg
Hhd, Hhd, Md, Md, Hh, Md, Md, Md, Md, Hhd, Hhd, Gs^Edpp, Gs, Rd, Gs, Hhd, Gd, Gs, Hh, Gd^Es, Gs, Gg, Gs, Gg, Gg, Ss, Ss, Ss, Ss, Ww^Ewl, Ss, Ss, Ww, Wot, Ww, Gg, Gg, Ss, Ss, Ss, Ww^Ewf, Gg, Gg, Gg, Gg, Ss, Gg, Ss, Gg, Gg, Gs, Gg, Gg
Xu, Hhd, Hhd, Md, Md, Hhd^Es, Md, Md, Md, Hhd^Fdw, Hhd, Hh, Hhd, Rd, Hhd, Hhd, Hhd, Hhd, Gd^Vo, Gd, Hh, Gg, Gg, Gs, Gs, Gg, Gg, Ss, Ss, Ww, Ss, Ss, Hh, Wot, Wot, Hh, Gs, Ss, Gg, Ss, Ss, Ss, Gg, Gg^Em, Ss, Ss, Gg, Gg, Gg, Gs, Gs, Gs, Rb^Gvs
Urb, Xu, Xu, Hhd, Md, Hhd, Hhd^Fdw, Hh, Md, Hhd, Hhd, Hhd, Hhd, Rd, Gs, Gd, Gg, Gd, Hhd, Hhd, Hhd, Gg, Gs, Gg, Gg, Gs, Gg, Gg, Ss, Ss, Gg^Efm, Ww, Gg^Em, Ww, Wot, Hh, Gs, Ss, Gg, Gg, Ss, Ss, Gg, Ss, Gg, Gg, Gg, Gg, Gg, Gg, Rb^Gvs, Rb^Gvs, Rb^Gvs
Urb, Urb, Urb, Xu, Xu, Md, Md, Hhd, Mm, Hhd, Hh, Hhd, Gs, Rd, Gs, Gs, Gd, Gs, Gd, Hhd, Hh, Gg, Gg, Gs, Gg, Gg, Ss, Gg, Gg, Ss, Ss, Ss, Gg, Ww, Wot, Ss, Gg^Efm, Gs, Ss, Ss, Ss, Gg, Gs, Gg^Efm, Ss, Gg, Ss, Gg, Gg, Rb^Gvs, Rb^Gvs, Re, Re
Urb, Urb, Xu, Urb, Xu, Md, Md, Md, Hh, Md, Hh, Gs, Rd, Rd, Rd, Gg, Gg, Gs, Gg, Hhd, Gg, Gg, Hh, Gs, Gs, Gg, Ss, Ss, Ss, Ss, Ss, Ss, Ww, Wwf, Wot, Wwf, Ww, Ss, Wot, Wot, Ww, Gg, Gg, Ds, Ss, Gg, Ss, Gg, Gg, Gg, Gg, Rb^Gvs, Gs
Xu, Xu, Xuc, Urb, Xu, Md, Md, Hh, Md, Md, Rd, Rd, Gg, Gs, Rd, Gs, Gd, Gs, Gs, Gg, Gs, Hhd, Gs, Gs, Gg, Gg, Gg, Gg, Gg, Ss, Ww, Ss, Rb, Ww, Wot, Wwf, Wot, Wot, Ww, Gg, Ss, Gg^Efm, Ss, Ss, Ds, Ss, Ww, Gg, Gg, Gg, Gg, Gg, Gg
Md, Md, Md, Urb, Mm, Md, Md, Hhd, Gd^Vo, Hhd, Rd, Hhd, Gd, Gs, Rd, Gs, Gs, Gd, Gd, Gs, Gg, Hhd, Gd, Hh, Gg, Gg, Gg, Gg, Ss, Ss, Ss, Ss, Ss^Vhs, Ss, Ww, Ww, Wot, Wot, Ss, Gg, Ss, Ss, Gg^Efm, Ds, Ww, Ww, Wot, Wot, Wot, Gg, Gg, Gg, Gg
Hhd, Hhd, Hhd, 3 Ko, Co, Hhd, Hhd, Hhd, Gd, Gs, Rd, Gd, Gd, Gs, Gs, Rd, Gg, Gs, Gs, Gd, Gd, Gs, Gs^Es, Gs, Gs, Gg, Gg, Gg, Gg, Ss, Ww, Ww, Ss, Ss, Ww, Wot, Ww, Wot, Ds, Ss, Sm, Ds, Ds, Wwf, Wot, Wot, Gg^Efm, Ss, Gg, Gg, Gg, Gg, Gs
Hhd, Hhd, Re, Co, Co, Co, Hhd, Hhd, Rd, Rd, Gd, Gs, Gg, Gs, Gg, Re, Gs, Gg, Gs, Gs, Gs, Gd, Gg, Gg, Gg, Gg, Gg, Ss, Ss, Ss, Gg, Gg^Efm, Gg, Gg, Wot, Ww, Ww, Wot, Ww, Ss^Vhs, Gg^Efm, Ss, Wwf, Wwf, Ss, Wot, Ss, Ss, Gg, Gg, Gg, Gg, Gg
Rd, Rd, Gd, Gs, Gd, Re, Rd, Rd, Gs, Gs, Rd, Hhd, Gs, Gd, Gs, Rd, Gs^Vo, Gs, Gg, Gs, Gg, Gs, Gs, Gg, Gg, Ss, Ss, Gg, Ss, Ss, Ss, Gg, Ww, Ww, Wot, Ww, Gg, Ss, Wot, Ww, Ww, Ww, Wot, Ww, Wot, Wot, Wwf, Gg, Gg, Ss, Gg, Gg, Gg
Gd, Gs, Gd, Gd^Es, Gd^Es, Gd, Gs, Rd, Rd, Gs, Gd, Gd, Gd, Gd, Gs, Rd, Rd, Gd, Gs, Gs, Gs, Gs, Gs, Gg, Gg, Ss, Ss, Gg, Ss, Ww, Ds, Wwf, Wot, Wot, Ss, Ds, Ss, Ss, Wot, Ww, Wot, Ww, Wot, Wot, Ww, Wot, Gg, Gg, Ss, Gg, Gg, Gg, Gg
Hhd, Hhd, Hhd, Hhd, Hhd, Gd, Gs, Gg, Gs, Rd, Rd, Gs, Gs, Gs, Gd, Gs, Gs, Rd, Gg, Gs, Gd, Gs, Gg, Gg, Gg, Ss, Ww, Ss, Gg, Gg, Ww, Wwf, Ss, Ss, Ss, Gg, Ss, Ss, Gg, Wot, Wot, Wot, Ss, Ww, Gg, Ss, Gg, Gg, Ss, Gg, Gg, Gg, Gg
Md, Md, Md, Md, Hhd, Hhd, Hhd, Gs, Gs, Gg, Gs, Rd, Rd, Gs, Gs, Gd, Gs, Rd, Rd, Gg, Gs, Gs, Gg, Gg, Ss, Ss, Ww, Ss, Ss, Gg, Ww, Ww, Ww, Gg, Ss, Ss, Gg, Ss, Gg, Ss, Ss, Ss, Ss, Gg^Efm, Gg, Hh, Gg, Ss, Ss, Gg, Gg, Gg, Gg
Gg, Md, Md, Md, Md, Hhd, Hhd, Hhd, Hhd, Gs, Gs, Gs^Vo, Gs, Rd, Rd, Gg, Gs, Gs, Rd, Gs, Gs, Gs, Gg, Gg, Gg, Gg, Ss, Ww, Ww, Ww, Wwf, Wot, Ww, Sm, Ss, Ss, Gg, Gg, Gg, Ss, Ss, Gg, Gg, Gg, Gg, Gg^Vc, Gg, Rb^Gvs, Gg, Gg, Gs, Gg, Gg
Md, Hhd, Md, Ms, Mm, Md, Hhd^Fdw, Gs, Hhd, Gs, Hhd, Hhd, Gd, Gs, Gs, Rd, Rd, Gs^Es, Rd, Gg, Gs, Gs, Gg, Gg, Gg, Gg, Ss, Ss, Ss, Gg, Ds, Wot, Wot, Gg, Ss, Ss, Ss, Ss, Gg, Ss, Sm, Ss, Gg, Ss, Ss, Gg, Gg^Emf, Ss, Gg, Gg, Gg, Gs, Gg
Md, Hhd, Hhd, Mm, Hh^Fp, Md, Md, Hhd, Hh, Hhd, Gs, Gs, Gd, Gd, Gd, Gs, Gs, Rd, Rd, Gs, Gs, Gd, Gg, Gg, Ss, Gg, Gg, Ss, Ww, Ss, Gg, Ww, Wot, Ww, Ww, Ss, Ss, Ss, Gg, Ss, Gg, Ss, Gg^Em, Gg, Ww, Ss, Ss, Ss, Gg, Gg, Gg, Gg, Gg
Md, Hhd, Gs, Hh, Hhd, Md, Hh, Md, Md, Gs, Gs, Gd^Es, Gs, Gg, Gs, Gs, Rd, Gs, Rd, Rd, Gs, Gs, Gs, Gg, Gg, Ss, Gg, Gg, Ss, Gg^Efm, Ww, Ww, Wot, Wot, Wot, Ww, Ss, Ss, Ww, Wot, Wot, Sm, Gg, Ss, Wot, Gg, Ss, Gg, Gg, Gg, Gg, Gg, Gg
Gs, Hhd, Gs, Gg^Es, Md, Hh, Gd^Vo, Md, Md, Hhd, Gs, Gd, Gs, Gs, Rd, Rd, Gs, Rd, Gs, Rd, Rd, Gs, Gs, Gg, Gg, Gg, Ss, Ss, Ss, Ss, Ww, Wot, Ww, Ww, Ss, Ww, Ww, Ss, Ss, Wot, Ww, Ds, Gg, Wot, Ss, Gg, Ww, Ss, Gg, Ss, Gg, Gg, Gg
Gs, Hhd, Hhd, Gs, Hhd, Hhd, Gd, Hhd, Hh, Hhd, Rd, Rd, Rd, Rd, Gs, Gs, Gs, Gd, Gs, Gs, Gg, Rd, Gs, Gs, Gg, Gg, Gg, Ss, Ss, Wwf, Ss, Ss, Ss, Ww, Ss, Sm, Ss, Ss, Ss, Ss, Sm, Ww, Ww, Gg, Sm, Gg, Ss, Ww, Ss, Gg, Gg, Gg, Gg
Hhd, Gs, Hhd, Hhd, Gs, Gs, Gs, Gs, Re, Re, Hhd, Gg, Gg, Gg, Gg, Gg, Gs, Gs, Gs, Gs, Gs, Rd, Re, Gs, Gg, Gg, Gg, Gg, Ss, Ss, Ss, Ss, Gg, Ww, Gg, Gg, Ww, Ss, Ww, Ss, Wot, Ss, Ww, Ss, Ss, Ww, Ss, Wot, Gg, Gg, Ss, Ss, Gg
Hhd, Hhd, Rd, Rd, Rd, Gs, Rd, Rd, Gs, Hhd, Md, Hhd, Hhd, Gg, Gg, Gg, Gg, Gs, Gg, Gg, Gg, Gg, Gg, Rd, Gg, Gg, Ss, Ss, Gg, Ss^Vhs, Gg, Ss, Wot, Gg, Wot, Ww, Wot, Wot, Wot, Wot, Wot, Ww, Wot, Gg, Gg, Ss, Gg, Gg, Ss, Gg, Gg, Gg, Gg
Rd, Rd, Gd, Gd^Edp, Gs, Rd, Re, Gs, Hhd, Hhd, Md, Md, Hh, Gs^Vo, Hh, Gg, Gg, Gg, Gg, Gg, Gg, Gg, Gg, Re, Re, Gg, Gg, Ss, Gg, Ss, Ww, Ss, Wot, Wwf, Wot, Wot, Ss, Ww, Ww, Wot, Ww, Ww, Ww, Sm, Ww, Ss, Ss, Gg, Gg^Efm, Gg, Gg, Gg, Gg
Gs, Hhd, Gd, Hhd, Hhd, Gd, Co, Gs, Rb, Hhd, Hhd, Mm, Hh, Hh, Ss, Ss, Ss, Gg, Ss, Gg, Ss, Gg, Ss, Gg, Gg, Rb, Rb, Gg, Ww, Ww, Ww, Wot, Ww, Ww, Ss, Ss, Ss, Ss, Ss, Gg, Ss, Gg, Ww, Gg, Gg, Ww, Wot, Ww, Ss, Ss, Ss^Vhs, Ss, Gg
Gs, Hhd, Hhd, Hhd, Hhd, Hhd, 2 Ko, Co, Hh, Rb, Rb, Mm, Hh, Hh, Ss, Gg, Ww, Ss, Ss, Ss, Gg, Ss, Gg, Ss, Ss, Gg, Ww, Wwf, Wwf, Ww, Ss, Gg, Gg, Ss, Gg, Ss, Gg, Gg, Gg, Gg, Gg, Ww, Gg, Ww, Gg, Ss, Wot, Sm, Ww, Ss, Gg, Gg, Gg
Hhd, Hhd^Fdw, Md, Gd^Vo, Md, Mm, Md, Hh, Md, Gg, Rb, Md, Hh, Gg^Efm, Ss, Ss, Ww, Ss, Ww, Ww, Wot, Ss, Gg^Em, Gg, Ss, Ss, Ww, Ww, Wwf, Rb, Gg, Gg, Ss, Gg, Hh, Hh, Hh, Gg, Hh, Hh, Ww, Ww, Ss, Ss, Ww, Ww, Sm, Gg, Gg, Ss, Gg, Gg, Gg
Md, Md, Ms, Md, Mm, Mm, Hhd, Md, Md, Mm, Rb, Mm, Hh, Gg, Gg, Ds, Ww, Ww, Ss, Ss, Ww, Wot, Wwf, Ss, Ds, Gg, Ww, Ww, Gg, Rb, Rb, Gg, Gg, Hh, Mm, Hh, Mm, Hh, Gs, Gg, Gg, Gg, Gg, Gg, Ss, Gg, Ss, Gg, Gg, Gg, Gg, Gg, Gg
Md, Mm, Mm, Mm, Gs, Gd, Gd^Es, Hh, Hh, Mm, Rb, Hh, Wot, Wot, Ww, Ww, Ss, Ww, Ss, Ss, Ww, Wot, Ss, Ss, Gg, Ww, Ww, Ss, Ss, Gg, Gg, Rb, Rb, Hh, Hh, Mm, Hh^Vo, Mm, Mm, Hh, Hh, Hh, Hh, Gg, Rb^Gvs, Gg, Gg, Gg, Gg, Gg, Gg, Gg, Gg
Hhd, Mm, Mm, Mm, Hh, Gd^Edpp, Gs, Hh, Gg, Wwf, Ww, Ww, Gg, Ww, Mm, Ss, Ss, Gg^Efm, Ds, Ww, Gg, Ww, Ww, Ss, Ww, Wot, Ww, Gg, Ss, Ss, Hh, Hh, Hh, Rb, Rb, Hh, Hh, Mm, Md, Mm, Mm, Hh, Hh, Gg^Vh, Rb^Gvs, Gg, Gs, Gg, Gg, Gs, Gs, Gg, Gs
Gd, Hhd, Md, Md, Md, Hh, Hh, Gg, Wot, Wot, Mm, Gg, Mm, Mm, Ss, Gg, Ss, Gg, Ww, Ww, Wwf, Ww, Gg, Ww, Ss, Wot, Wot, Gg, Mm, Hh, Mm, Mm, Mm, Hh, Re, Hh, Gg, Hh, Hh, Hh, Hh, Md, Gg, Hh, Gg, Gg, Gs, Gg, Gs, Gs, Gs, Gg, Gs
Gd, Gd^Es, Gd, Md, Md, Md, Mm, Mm, Wot, Mm, Mm, Mm, Mm, Gg, Ss, Gg^Efm, Wwf, Gg, Ww, Wwf, Gg^Efm, Ss, Ww, Ss, Ss, Ww, Mm, Mm, Hh, Mm, Hh, Hh, Gg, Md, Hh, Rb, Re, Hh, Gs, Hhd, Gs, Hhd, Hh, Hh, Gg, Gs, Gs, Gs, Gs, Gs, Gs, Gg, Gs^Es
Hhd, Hhd, Md, Md, Mm, Mm, Gg, Wot, Mm, Mm, Mm, Md, Mm, Rb^Gvs, Ss, Ss, Ww, Wwf, Ww, Ww, Gg, Ss, Gg, Ss, Ww, Ww, Mm, Hh, Gg^Vo, Gg, Gg, Hh, Gg, Gs, Gg, Gg, Gs, Re, Re, Re, Rd, Gs, Gs, Hhd, Gs, Gs, 1 Gs, Gs, Gs, Gs, Gs, Gs, Gs
Md, Md, Hh, Mm, Hh, Hh, Gg, Wot, Gg, Gs, Gs, Gg, Gg, Gg^Vc, Ss, Gg^Em, Ss, Ss, Ww, Ww, Ww, Ss, Gg, Gg^Em, Ww, Ww, Mm, Hh, Hh, Gg, Md, Gg, Hhd, Hh, Hhd, Hhd, Hhd, Hh, Gs, Hhd, Hhd, Re, Rd, Gs, Gs, Gs, Hh, Gs, Gs, Gs, Gs, Gs, Gs
Hhd, Hh, Gs, Hh, Gg, Hh, Ww, Ww, Gs, Gg, Ss, Ss, Gg, Ss, Gg, Gs, Ds, Ds, Ww, Wot, Ww, Ww, Gg, Ss, Ss, Ww, Mm, Hh, Mm, Md, Mm, Md, Md, Hh, Md, Gs, Gs, Hhd, Hhd, Gs, Hhd, Gs, Hhd, Rd, Co, Hh, Hhd, Hhd, Hh, Gs, Gs, Gs, Gg
Gd, Gs, Gg, Gg, Gg, Gg, Ww, Ds, Gg, Ds, Ds, Ds, Ds, Gs, Ds, Ds, Ww, Ww, Ww, Wot, Ww, Wwf, Ds, Ds, Gg, Ww, Gg, Mm, Md, Hh, Hh, Hh, Md, Md, Md, Md, Md, Gs, Hhd, Hhd, Gd, Hhd^Vo, Gd, Co, Ko, Co, Md, Hh, Hhd, Gd, Gd, Gs, Gs
Gg, Gs, Gg, Gs, Gg, Ds, Ww, Ds, Ds, Ds, Wwf, Wwf, Ww, Ds, Ww, Wwf, Ww, Ww, Wot, Wot, Wot, Ww, Ww, Ds, Ds, Ww, Gg, Mm, Mm, Hh, Gs, Hhd, Md, Md, Hhd, Md, Hh, Md, Md, Hhd, Md, Md, Md, Md, Md, Gs, Hh, Md, Hhd, Hhd, Hhd, Gs, Gd^Es
Gs, Gg, Ds, Ds, Ds, Ds, Ww, Ww, Ww, Wwf, Wot, Ww, Wot, Ww, Wot, Wot, Wot, Wot, Wot, Wot, Wot, Wot, Wot, Wwf, Ww, Ww, Ds, Hh, Mm, Hh, Gs, Hh, Md, Hhd, Gs, Gs, Md, Md, Hhd, Md, Md, Hh, Mm, Mm, Md, Md, Md, Md, Hhd, Gs, Md, Hhd, Hhd
Gg, Gg, Ds, Ds, Ww, Ww, Ww, Wot, Wot, Wot, Wot, Wot, Wot, Wot, Wot, Wot, Wot, Wot, Wot, Wot, Wot, Wot, Wot, Wot, Wot, Ww, Ww, Ds, Mm, Hh, Gg, Hh, Gg, Md, Gs, Md, Gs, Gd, Gs, Md, Gd, Md, Gs, Md, Hhd, Hhd, Gs, Md, Hhd, Hhd, Md, Md, Hh
