border_size=1
usage=map

Ds, Ww, Ww, Ww, Ww, Ww, Ww, Wo, Wo, Wo, Ww, Ds, Gg, Gg, Ss, Ss, Gg, Ds, Ww, Gg, Ww, Wo, Wo, Ww, Ww, Wo, Ww, Ww, Wo, Wo, Ww, Ww, Ww, Ww, Ww, Ww, Ds, Gg, Gg, Mm, Mm, Mm, Gg, Hh, Rb, Rb, Mm, Hh, Mm, Hh, Mm, Mm, Mm, Hh, Hh, Gg, Mm, Hh
Ds, Ds, Ww, Ww, Ww, Ww, Ww, Ww, Ww, Wo, Ww, Ds, Ds, Ds, Ww, Ww, Ds, Ds, Ww, Ww, Ww, Ww, Wo, Ww, Ww, Ww, Ww, Ww, Wo, Wo, Ww, Ww, Ww, Ww, Ds, Ds, Gg, Gs, Hh, Mm, Hh, Hh, Rb, Rb, Hh, Hh, Gg, Hh, Gs, Hh, Hh, Hh, Hh, Hh, Mm, Hh, Gg, Hh
Gs, Gs, Gs, Gs, Ww, Ww, Ww, Gs, Gs, Ww, Ww, Ww, Ww, Ww, Ww, Ww, Ds, Ds, Gs, Ww, Wo, Wo, Ww, Ww, Wo, Ww, Ww, Wo, Ww, Ww, Ww, Ww, Gg, Ds, Hd, Gg, Hh, Hh, Hh, Hh, Hh, Hh, Rb, Gg, Gg, Hh, Mm, Mm, Mm, Hh, Mm, Hh, Mm, Mm, Mm, Mm, Mm, Mm
Gg, Gs, Gs, Ds, Ds, Ww, Ds, Gg, Wwf, Ww, Wo, Ww, Ww, Ww, Hd, Ds, Gg, Gg, Ww, Ww, Ww, Ww, Ww, Wo, Wo, Wo, Wo, Ww, Ww, Ww, Ds, Ds, Gg, Hd, Gg, Gg, Hh, Hh, Mm, Mm, Hh, Hh, Rb, Gg, Hh, Hh, Mm, Mm, Hh, Hh, Hh, Mm, Mm, Mm, Mm, Hh, Hh, Mm
Gs, Gs, Gs, Gs^Vc, Ww, Ww, Ww, Ww, Ww, Ww, Wo, Wo, Wo, Wo, Wo, Ds, Gg, Gg^Vc, Gg, Ww, Ww, Ww, Wo, Ww, Wo, Wo, Wo, Wo, Wo, Ww, Ds, Gg, Gs, Gg, Gs, Hh, Hh, Hh, Hh, Hh, Gg^Vhh, Gg, Rb, Hh, Hh, Hh, Mm, Mm, Mm, Hh, Mm, Mm, Mm, Mm, Hh, Gg^Efm, Mm, Gs
Gg, Gs, Gg, Ds, Gs, Ww, Ww, Ww, Wo, Wo, Wo, Wo, Wo, Wo, Ww, Ww, Ds, Gg, Gs, Gs, Gs, Ww^Bw/, Ww, Wo, Wo, Wo, Wo, Ww, Wo, Wo, Gg, Gg, Gg, Gs, Gg, Gg^Es, Hh, Mm, Hh, Rb^Gvs, Hh, Hh, Rb, Gg, Hh, Mm, Mm, Mm, Mm, Mm, Hh, Hh, Hh, Gg, Gs^Es, Mm, Hh, Mm
Gs, Gg, Gs, Gg, Gs, Hd, Wo, Wo, Wo, Wo, Wo, Wo, Wo, Wo, Ww, Ww, Ww, Ds, Gs, Gg, Gg, Ww, Ww, Ww, Wo, Wo, Wo, Ww, Ww, Ww, Ds, Gg, Gs, Gs, Gs, Gg, Hh, Hh, Gg, Hh, Hh, Hh, Rb, Hh, Gg, Mm, Mm, Mm, Mm, Mm, Mm, Hh, Hh, Hh, Hh, Gg, Gg, Hh
Hh, Gg, Gg, Gs, Gg, Ds, Ds, Wo, Wo, Wo, Ww, Wo, Ww, Ww, Ww, Ww, Ds, Ds, Gg, Gs, Gs^Es, Gs, Ww, Ww, Wo, Wo, Wo, Wo, Ww, Ww, Ds, Gg, Gg, Gs, Gg, Gg, Gs, Gg, Gg, Hh, Hh, Gg, Rb, Hh, Hh, Hh, Mm, Mm, Hh, Mm, Hh, Mm, Mm, Mm, Mm, Hh, Mm, Hh
Gs, Hh, Gs, Gs, Gg, Gs, Ds, Wo, Wo, Ww, Ww, Ww, Ds, Ds, Ds, Ds, Hd, Gg, Gs, Gs, Gg, Gs, Ww, Ww, Wo, Wo, Wo, Wo, Ww, Ww, Ww, Ds, Ds, Gg, Gs, Gg, Gs, Hh, Gg, Hh, Gg, Rb, Gg, Hh, Gs^Es, Hh, Hh, Mm, Hh, Mm, Gg, Hh, Hh, Hh, Hh, Hh, Mm, Mm
Mm, Mm, Hh, Hh, Hh, Gs, Ds, Ww, Ww, Ww, Ww, Ww, Ds, Gg, Gg, Hd, Gg, Gg, Gs, Gg, Ww, Ww, Ww, Ww, Ww, Ww, Wo, Wo, Ww, Ww, Ww, Ww, Ds, Gg, Gg, Gs, Gs, Gg, Gg, Gg, Rb, Rb, Gg, Hh, Gs, Gg, Hh, Hh, Hh, Hh, Mm, Mm, Mm, Hh, Hh, Mm, Mm, Mm
Hh, Mm, Mm, Gg, Hh, Hh, Gs, Ds, Ww, Ww, Ww, Ds, Gg, Gg, Ww, Gg, Ds, Gg, Gg, Gg, Ww, Gg, Gs, Ww, Ww, Ww, Ww, Ww^Bw|, Gg, Ww, Ww, Ww, Ww, Gg, Wo, Gg, Gg, Gg, Gg, Gg, Rb, Gg, Gg, Gg, Gs, Gs^Es, Gg, Hh, Hh, Hh, Mm, Hh, Hh, Mm, Hh, Mm, Mm, Mm
Gg, Mm, Mm, Mm, Gs, Gg, Gs, Ds, Ds, Ww, Ww, Ds, Ww, Ww, Ww, Ww, Gg, Gg, Wo, Gg, Ww, Gg, Ww, Ww, Gg, Ww, Gg, Gg^Vc, Gs, Gs, Gg, Wwf, Ww, Ww, Gg^Vc, Gg, Gs, Gs, Rb, Rb, Gs, Gs, Gs, Gs, Gg, Gs, Hh, Hh, Gg, Gs, Hh, Mm, Hh, Hh, Mm, Gg, Mm, Hh
Hh, Mm, Mm, Hh, Hh, Hh, Gg, Gg, Gg, Ww, Ww, Ww, Ww, Ww, Ww, Ww, Ww, Ww, Ww, Ww, Ww, Ww, Gg, Gg, Gg, Gs, Gs, Gg, Gg, Gg, Ww, Ww, Ww, Gg, Gg, Gg, Gg, Gg, Rb, Gg, Gs, Gg, Gg, Gg, Gg, Gg, Gg, Gs, Gg, Hh, Gg, Mm, Gg, Mm, Ww, Mm, Hh, Hh
Mm, Mm, Hh, Gg, Mm, Mm, Hh, Hh, Gg, Ww, Ww, Ww, Ss, 2 Khs, Chs, Ww, Ww, Ww, Ds, Ww, Ds, Gg, Gg, Gg, Gg, Gg, Gg, Wo, Ww, Ww, Gg, Ww, Ww, Gg, Gg, Gs, Gg, Rb, Gg, Gg, Gg, Gg, Gg, Gg, Gg^Vc, Gg, Gg, Gg, Gg, Gg, Hh, Hh, Hh, Mm, Mm, Ww, Ww, Gg
Mm, Mm, Ms, Hh, Ms^Xm, Mm^Xm, Mm, Mm, Hh, Ww, Gg, Ss, Ss, Ss, Chs, Chs, Gg, Ds, Ss, Ds, Ss, Gg, Gg, Gg, Gg, Gg, Ww, Ww, Ww, Gg, Gg, Ww, Wo, Wwf, Wo, Gg, Rb, Rb, Gg, Gg, Gg, Gg, Gg, Gg, Gg, Rb^Gvs, Gg, Gg, Gg, Gs^Es, Gg, Hh, Gg, Hh, Hh, Hh, Ww, Hh
Mm^Xm, Mm, Ms, Mm, Wo, Hh, Wo, Wo, Ww, Wo, Gg, Ww, Ss, Ss, Ss, Ss, Ss, Gg, Ss, Sm, Gg^Efm, Ss, Gg, Gg, Gg, Gg, Gg, Gg, Wo, Gg, Ss, Gg, Gg, Wwf, Ww, Ww, Wwf, Gg, Gg, Gg, Ss, Gg, Ss, Gg, Gg, Gg, Gg, Gg, Gg, Gs, Gg, Gg, Gg, Gg, Gg, Gg, Gg, Ww
Mm^Xm, Ms^Xm, Wo, Wo, Hh, Wo, Mm, Mm, Mm, Sm, Gg, Gg^Efm, Ss, Ss, Ss, Ss, Ss, Ss, Ss, Ss, Ss, Ss, Gg, Gg, Ss^Vhs, Gg, Ss, Ww^Ewl, Gg, Gg, Ss, Gg, Gg, Gg, Ww, Ww, Wwf, Ww, Gg, Ss, Ss, Ss, Gg, Ss, Gg, Ss, Gg, Gg, Gg, Gg, Gg, Gg, Ss, Gg, Gg^Efm, Ss, Ss, Gg
Ms, Ms, Wo, Gg, Hh^Vhh, Mm, Mm, Mm, Mm, Hh, Hh, Gg, Gg, Gg, Ss, Gg^Efm, Ss, Ss, Ss, Ss, Ss, Ss, Ss, Gg, Ss, Gg, Ss, Ww, Ss, Ss, Ss, Ss, Ss, Gg, Rb, Rb, Ww, Ww, Ww, Ss, Gg^Em, Ss, Gg, Gg, Gg, Gg, Ss, Ss, Gg, Gg, Ss, Gg, Ww, Gg, Ww, Gg, Gg, Ww
Ms, Ms, Ms, Mm, Mm, Mm, Ms, Ms, Mm, Mm, Hh, Gg, Ss, Gg, Gg, Ss, Gg, Gg, Gg, Ss, Gg, Gg, Gg, Ss, Ss, Ss, Ss, Ss, Ss, Ss, Ss, Ss, Ss, Rb, Gg, Gg, Gg, Wo, Wo, Ww, Ss, Ss, Ss, Ss, Gg, Ss, Ss, Sm, Ss, Gg, Gg, Gg, Ss, Gg, Gg, Ss, Ss, Wo
Mm^Xm, Ms, Ms, Mm, Mm, Mm, Mm, Mm, Mm, Gg, Gg, Gg, Hh, Gg, Gg, Gg, Gg, Gg, Gg, Gg, Ss^Vhs, Ss, Ss, Gg, Ss, Ss, Gg, Gg, Gg, Gg^Efm, Ss, Ss, Rb, Rb, Ss, Gg, Gg, Ww, Ww, Ww, Ww, Ss, Ss, Ss, Gg^Efm, Ss, Ww, Ss, Gg, Ss, Ss, Ww, Gg, Ss, Gg, Ss, Ss, Wo
Mm^Xm, Ms, Mm, Mm, Hh, Mm, Mm, Mm, Mm, Mm, Gg, Gg^Efm, Gg, Gg, Gg, Gg, Gg, Gg, Gg, Gg, Rb, Ss, Ss, Ss, Gg, Ss, Ss, Hh, Hh, Hh, Ss, Ss, Rb, Ss, Ss, Ss, Ss, Ss, Ss, Wwf, Ss, Wo, Ww, Ss, Ss, Gg, Ss, Ss, Gg, Ss, Gg, Ww^Ewl, Gg, Wo, Ss, Ss, Ww, Ss
Mm, Mm^Xm, Mm, Mm, Mm, Hh, Hh, Mm, Hh, Hh, Hh, Gg, Gg, Gg, Gs, Gg, Gg, Gg, Gg, Gg, Gg, Gg, Ss, Ss, Ss, Gg, Hh, Hh, Gg, Ss, Ss, Rb, Ss^Vhs, Ss, Ss, Gg, Gg, Ss, Ww, Ss, Ss, Ww, Wo, Ww, Ss, Ss, Gg, Gg, Ss, Gg, Ss, Gg, Ss, Ss, Gg, Gg, Ww, Gg
Mm, Hh, Mm, Mm, Mm, Mm, Mm, Mm, Mm, Mm, Hh, Gg, Gg, Gs, Gg, Gg, Gg, Gg, Gg, Gg, Hh, Gg, Gg, Ss, Ss, Ss, Gg, Hh, Ss, Ss, Rb, Rb, Ss, Ss, Gg, Ss, Ss, Ss, Ss, Ss, Ss, Ss, Ss, Ww, Ww, Gg, Ss, Gg, Gg, Ww, Ss, Gg, Ss, Wo, Gg, Ww, Gg, Gg
Hh, Hh, Hh, Hh, Mm, Hh, Hh, Mm, Hh, Gg, Gg, Gs, Gs, Gs, Gg, Gs, Gg, Gs, Gg, Gg, Gg, Gg, Gg, Ss, Ss, Ss, Ss, Gg, Ss, Ss, Rb, Ss, Ss, Gg, Ss, Gg, Ss, Ss, Gg, Ss, Sm, Ss, Ss, Wwf, Ww, Ss, Ww, Ss, Gg, Ww, Ss, Ss, Ss, Ss, Ss, Gg, Ww, Wo
Mm, Mm, Mm, Mm, Mm, Hh^Vhh, Gs, Hh, Hh, Gs, Gs, Hh, Gs, Gs, Gs, Gs^Es, Gs, Gs, Gs, Gs, Gg, Gg, Hh, Gg, Gg, Gg, Gg, Gg, Gg, Rb, Ss, Gg, Hh, Ss, Ss, Ss, Ss, Gg, Ss, Ss, Ss, Gg, Ss, Ww, Ww, Ss, Ss, Ss, Ww, Gg, Ss, Ss, Gg, Ss, Gg, Ss, Ww, Ss
Mm, Mm, Mm, Mm, Mm, Mm, Hh, Gs, Gs, Hh, Gs, Gs, Hh, Hh, Hh, Gg, Hh, Gs, Hh, Gs, Gs, Gg, Gg, Gg, Hh, Hh, Gg, Gg, Rb, Rb, Ss, Gg, Gg, Hh, Ss, Gg^Efm, Ss, Ss, Ss, Ss, Ww, Gg, Ss, Ww, Wo, Ss^Vhs, Wo, Ww, Ww, Gg, Gg, Gg^Efm, Ss, Gg, Ss, Wo, Ss, Gg
Mm, Mm, Hh, Mm, Mm, Mm, Mm, Gs^Es, Hh, Gs, Gg, Gs, Gs, Gs, Gs, Rb^Gvs, Rb^Gvs, Hh, Gg, Gg, Gg, Gg, Gg, Gg, Gg, Gg, Gg, Rb, Gg, Gg, Gg, Hh, Gg, Ss, Gg^Em, Gg, Ss, Ss, Ss, Gg, Ss, Ss, Ss, Ww, Ww, Wo, Gg, Ss, Ss, Ss, Ww, Ss, Wo, Ss, Ww, Ss, Wo, Wo
Mm, Mm, Mm, Mm, Mm, Mm, Mm, Mm, Mm, Gs, Gg, Gs, Gs, Gs, Hh, Rb^Gvs, Hh^Vhh, Gg, Gg, Gg, Gs, Gg, Gg, Gs, Gs, Gg, Rb, Rb, Gg, Hh, Gg, Ss, Ss, Ss, Ss, Ss, Gg, Gg, Gg, Gg^Em, Ss, Gs^Fp, Ww, Ww, Ss, Ww, Wo, Ds, Wo, Wo, Wo, Ss, Ss, Ss, Wo, Wo, Ss, Gg
Mm, Mm, Mm, Hh, Mm, Mm, Mm, Mm, Hh, Rb^Gvs, Rb, Gg, Gs, Hh, Gs, Hh, Gs, Gs, Gs, Hh, Hh, Gs, Gs, Gs, Gg, Gg, Rb, Gg, Gg, Hh, Gg, Gg, Ss, Ss, Ss, Ss, Ww, Ss, Ss, Ss, Ww, Ww, Ss, Ss, Ss, Ww, Ww^Ewl, Wo, Ww, Ss, Ss, Wo, Wo, Wo, Ss, Gg, Ss, Wo
Mm, Mm, Mm, Mm, Mm, Mm, Mm, Mm, Hh, Hh^Vhh, Hh, Hh, Gs, Hh, Hh, Gs, Gs, Gs, Hh, Hh, Gg, Hh, Gs, Gg, Gg, Rb, Gg, Gg, Gg, Gg, Ss, Ss, Gg, Ss, Gg, Ss^Vhs, Ss, Ss, Gg^Efm, Ss, Ww, Ss, Chs, Chs, 3 Khs, Ww, Sm, Gg^Efm, Ww, Ss, Ss, Gg, Ss, Ww, Ww, Ss, Gg, Ss
Hh, Mm, Mm, Mm, Mm, Mm, Mm, Gs, Hh, Rb^Gvs, Gg, Gs, Gs, Hh, Gs, Gs, Hh, Hh, Hh, Gg, Hh, Gg, Gs, Gg, Re, Rb, Gg, Gg, Hh, Gg, Gg, Ss, Ss, Ss, Ss, Ss, Ss, Ss, Ss, Ss, Ss, Ww, Ww, Chs, Ss, Ss, Ss, Ww, Gg, Ss, Ss, Ss, Ss, Ss, Ss, Ss, Ss, Ss
Gg, Hh, Mm, Mm, Mm, Mm, Mm, Gg, Hh, Gg, Gs, Gs, Hh, Hh, Hh, Gs, Gs, Gs, Gs^Es, Hh, Hh, Gs, Gs, Gs, Rb, Gs, Gg, Hh, Hh, Hh, Gg, Gg, Ss, Ss, Ss, Gg, Ss, Ss, Ww, Sm, Ss, Ss, Wwf, Ss, Ss, Ss, Ss, Ww, Gg, Gg, Ss, Gg^Efm, Ss, Gg, Ww^Ewl, Gg, Ss, Gg
Mm, Mm, Mm, Hh, Mm, Mm, Mm, Mm, Hh, Gs, Hh, Hh, Re^Gvs, Gs, Gs, Gs, Hh, Gs, Gs, Gs, Hh, Gs, Gg, Gg, Rb, Gg, Gg, Gg, Hh, Gg, Gg, Gg, Ss, Gg, Ss, Gg, Gg, Ss, Ss, Ss, Ww, Ss, Ww, Ww, Ss, Ss, Ww, Ww, Ss, Ss, Gg, Wo, Ss, Ss, Gg, Ss, Rb, Rb
Mm, Mm, Mm, Mm, Mm, Mm, Mm, Mm, Gg, Gs^Es, Gs, Re, Hh^Vhh, Hh, Gs, Gs, Gs, Gs, Gs, Gs, Gs, Gs, Gg, Rb, Gg, Gg, Hh, Hh, Gg, Gg, Gg, Gg, Ss, Ss, Ss, Ss, Ss, Ss, Ss, Ss, Ss, Ss, Ss, Ww, Ss, Ss, Ww, Ss, Gg, Ss, Wo, Ss, Gg, Ss, Ss, Ss, Gg, Gg
Mm, Mm, Mm, Mm, Mm, Mm, Mm, Mm, Mm, Hh, Gs, Gg, Hh, Gs, Gs, Gs, Gs, Gs, Gg, Gs, Gs, Gs, Rb, Rb, Gg, Gg, Gg, Gg, Gg, Gg, Ww, Ss, Gg, Gg, Ss, Gg^Efm, Ss, Ss, Ss, Gg, Ss, Gg, Ss, Ww, Ww, Ww, Ss, Ss, Ww, Ss, Ss, Ss, Wo, Gg, Ss, Rb, Ss, Wwt
Gg, Mm, Mm, Mm, Mm, Mm, Mm, Mm, Mm, Gs, Hh, Hh, Hh, Hh, Hh, Hh, Gs, Gs, Gg, Gg, Gg, Gg, Rb, Gg, Gg, Gg, Gg, Gg, Gg, Gg, Gg^Vc, Hh, Hh, Gg, Ss, Gg, Ss, Ss, Gg, Gg, Ss, Ss, Ss, Wo, Ss, Ss, Ss, Gg, Gg, Ss, Ss, Ss, Gg, Ss, Rb, Ss, Ss, Ss
Wo, Wo, Ms, Mm^Xm, Mm, Mm^Xm, Mm, Mm, Hh, Hh, Hh, Gs, Gs, Hh, Gs, Gs, Gg, Gg, Gg, Gg, Gg, Gg^Vc, Wwf, Gg, Ww, Gg, Wwf, Wwf, Ww, Ww, Wwf, Ss, Gg, Ss, Ss, Ss, Gg, Gg, Gg, Gg, Ss, Sm, Ss, Wo, Ww, Ss, Gg, Ss, Ww, Ss, Ww, Ss, Sm, Ss, Gg, Gg, Ww, Ss
Mm, Mm, Hh, Mm, Mm, Mm, Mm, Gs, Hh, Hh, Gs, Gs, Gs, Gs, Gs, Gs, Gs, Gs, Gg, Gg, Ww, Ww, Rb, Ww, Gg, Ww, Gg, Gg^Efm, Gg, Gg, Gg, Ww, Ww, Ss, Ww, Sm, Ww, Ss, Ww, Ww, Ww, Ww, Ww, Ww, Wo, Ww, Wo, Ds, Gg, Ss, Ss, Ss^Vhs, Rb, Ss, Gg, Ss, Gg, Ss
Hh, Mm, Gg, Mm, Mm, Mm, Mm, Hh, Hh, Gs, Gs, Gg, Gs, Gg, Gg, Gg, Gg, Gg, Gg, Wwf, Gg, Gg, Rb, Gg, Gg, Gg, Gg, Gg, Gg, Gg, Gg, Gg, Ww, Ww, Ww, Ww, Wo, Wo, Wo, Wo, Ww, Ww, Wo, Ww, Wo, Ww, Ww, Wwt, Wo, Ss, Gg, Ss, Gg, Gg, Ss, Gg, Hh, Gg
Gg, Hh, Gg, Mm, Mm, Hh, Mm, Mm, Hh, Hh, Hh, Gs^Es, Gg, Gs, Gg, Gg, Gg, Gg, Ww, Wwf, Gg, Gg, Rb, Gg, Gs, Gg, Gs, Gg, Gg, Gs, Gg, Gg, Gg, Ww, Wo, Wo, Wo, Wo, Ww, Ww, Ss, Ww, Ww, Wo, Ww, Ww, Ww, Ss, Ww, Gg, Rb, Ss, Gg, Ss, Gg, Gg, Gg, Gg
Mm, Mm, Mm, Mm, Mm, Mm, Mm, Mm, Hh, Hh, Hh, Gg, Gg, Gg, Gg, Gg, Ww, Ww, Gg, Gg, Gg, Gg, Rb, Gs, Gs, Gg, Gs, Gs, Gg, Gg, Gg, Gg, Ww, Gg, Ww, Ww, Gg, Ww, Ww, Gg, Gg, Ww, Ww, Gg, Ss, Ss, Ss, Ww, Wo, Ww, Rb, Ss, Ss, Ss, Gg, Hh, Gg, Gg
Gg, Mm, Gg, Mm, Mm, Hh, Mm, Mm, Mm, Hh, Hh, Gg, Ww, Gg, Wwf, Ww, Gg, Gg, Gs, Gg, Gg, Gg, Rb, Gs, Re, Gs^Es, Gg, Gg, Gs, Gg, Gg, Ww, Ww, Ww, Gg, Gg, Gg^Vc, Ww, Ww, Ww, Ss, Ww, Ww, Gg, Ss, Ss, Gg, Ss, Gg, Wwf, Wwf, Ss, Hh, Hh, Hh, Mm, Gg, Gg^Efm
Gg, Gg, Mm, Mm, Hh, Hh, Hh, Mm, Wo, Ww, Ww, Wwf, Gg, Ww, Gg, Gg, Gg, Gg, Gs, Gs, Re, Rb, Hh, Re, Gs, Rb, Gs, Gg, Gg, Gg, Gg, Gg, Wo, Gg, Gg, Gg, Gg, Ds, Ds, Ss, Gg, Ww^Ewf, Ss, Gg^Vc, Gg, Gg, Gg, Rb, Hh, Gg, Gg, Wo, Wo, Hh, Hh, Hh, Mm, Hh
Mm, Mm, Mm, Mm, Wo, Wo, Ww, Ww, Mm, Mm, Gg, Gg, Gg, Gg, Gs, Gg, Hh, Hh, 1 Re, Re, Hh, Hh, Mm, Hh, Hh, Gs, Gg, Re, Rb, Gg, Gg, Ww, Gg, Gg, Gs, Gg, Gg, Gg, Rb, Gg, Gg, Gg, Gg, Gg, Rb, Gg, Hh, Gg, Gg, Gg, Hh, Ww, Ww, Hh, Gg, Hh, Mm, Mm
Mm, Hh, Hh, Mm, Wo, Mm, Hh, Gg^Efm, Mm, Mm, Hh, Gg, Hh, Gg, Hh, Gg, Gs, Gs, Re, Hh, Gs, Gs, Gs, Mm, Gs^Es, Hh, Gs, Gg, Gs, Rb, Rb, Ww, Wwf, Gg, Rb, Gs, Rb, Rb, Hh, Gg, Rb, Rb, Gg, Gg, Hh, Hh, Hh, Gg, Hh, Hh, Gg, Mm, Wo, Mm, Mm, Mm, Mm, Mm
Hh, Mm, Wo, Wo, Hh, Hh, Mm, Mm, Mm, Mm, Mm, Hh, Mm, Mm, Hh, Gs, Mm, Hh, Gs, Re, Rb, Hh, Hh, Hh, Hh, Hh, Gg, Gg, Gg, Gs, Gg, Gg, Ww, Hh, Hh, Hh, Hh, Hh, Hh, Gs, Gg, Gs, Hh, Hh, Mm, Hh, Mm, Gg, Hh, Hh, Mm^Xm, Mm^Xm, Mm, Mm, Mm, Mm, Hh, Mm
Mm, Mm, Wo, Mm, Mm, Mm, Gd, Mm, Hh, Mm, Mm, Mm, Hh, Mm, Hh, Mm, Mm, Mm, Hh, Gs, Rb, Hh, Mm, Mm, Hh, Mm, Gs^Es, Gs, Gs, Gs, Gg, Hh, Hh, Ww, Ww, Hh, Mm, Gg^Efm, Mm, Hh, Gg, Mm, Mm, Mm, Hh, Mm^Xm, Mm^Xm, Mm^Xm, Mm, Mm, Hh, Hh, Hh, Mm^Xm, Hh, Hh, Gg, Gg
