border_size=1
usage=map

Wo, Wo, Wo, Wo, Wo, Wo, Wo, Wo, Wo, Wo, Wo, Wo, Ww, Ww, Ww, Ww, Ds, Gs, Ds, Gs, Gg, Gs, Gs, Gg, Gs, Gs, Gg, Gg, Ss, Ww, Ww, Ss, Gg, Gg, Ww, Ss, Gg, Ss, Ss, Ww, Ss, Gg, Ss, Gg, Sm, Ww, Ww, Gg, Ww^Ewl, Ss, Ss, Ss, Gg, Hh, Mm, Mm, Hh, Hh, Gs, Hh, Md, Gs, Hh, Md, Mm^Xm, Hhd, Hhd, Hhd, Hhd, Gd, Hhd, Gd, Gd, Gd, Gs, Gd
Wo, Wo, Wo, Wo, Wo, Wo, Wo, Wo, Wo, Wo, Wo, Ww, Wo, Ww, Wo, Wo, Wo, Ds, Ww, Ds, Gs, Gs, Gg, Gs, Gs^Es, Gg, Gg, Gg, Ss, Ww, Ww, Ww, Ww, Ww, Gg^Efm, Ss, Ss, Ss, Ww, Wwf, Ss, Gg, Ss, Ss, Wwf, Wwf, Ss, Gg, Ss, Ss, Ss, Gg, Gg^Em, Hh, Mm, Mm, Hh, Hh, Gs, Hh, Hh, Md, Md, Mm^Xm, Mm, Hhd, Hhd, Gd, Gd^Es, Gd, Gd, Gd^Es, Gd, Hhd, Gd^Edp, Gd
Wo, Wo, Wo, Wo, Wo, Wo, Wo, Wo, Wo, Wo, Wo, Ww, Ww, Ww, Ww, Ww, Ww, Ww, Ww, Ww, Ww, Ds, Ww, Gs, Ds, Gg, Gg, Gg, Ss, Gg, Gg, Ss, Sm, Ss, Ss, Ss, Gg, Ss, Ss, Ww, Ww, Ww, Ww, Ww, Ss, Ss, Ss, Ss, Gg, Gg, Ss, Gg, Gg, Hh, Mm, Mm, Hh, Hh, Gs, Gs, Gs^Es, Hh, Hh, Mm^Xm, Mm, Hhd, Gs, Gd, Hhd, Gd, Gs, Hhd, Gd, Gs, Gd, Gd
Wo, Wo, Wo, Wo, Wo, Wo, Wo, Wo, Wo, Wo, Wo, Wo, Wo, Wo, Wo, Wo, Wo, Ww, Ww, Ww, Ww, Ww, Ww, Ww, Ds, Gs, Gg, Gg, Gg, Gg, Gg, Gg, Gg, Gg, Gg, Ss, Ss, Gg, Ss, Gg, Wwf, Ss, Gg, Sm, Ss, Gg^Efm, Ss, Gg, Ss, Ss, Gg, Gg, Hh, Hh, Mm, Mm, Mm, Hh, Gs, Hh, Hh, Gs, Hh, Mm^Xm, Mm, Gs, Hhd, Hhd, Gd, Gd, Gd^Es, Gd, Gd, Gd, Rd, Rd
Gd, Hh, Wo, Wo, Wo, Wo, Wo, Wo, Wo, Wo, Wo, Wo, Wo, Wo, Wo, Wo, Wo, Ww, Ww, Wo, Ww, Wwr, Ww, Ww, Ww, Ww, Ww, Gs, Gg, Gs, Gs, Gg, Gg, Ss, Gg, Gg, Ss, Ss, Ss, Ww, Ww, Gg, Gg, Ss, Gg, Gg, Ss, Gg, Gg, Gs, Gs, Hh, Hh, Hh, Mm, Hh^Vhh, Hh, Gs, Gs, Hh, Hh, Ww, Mm^Xm, Mm^Xm, Hhd, Hhd, Hhd, Hhd, Gd, Gs, Gd, Gd, Rd, Rd, Gd, Hhd^Vhhr
Gd, Ww, Ww, Wo, Ww, Ww, Wo, Wo, Wo, Wo, Wo, Wo, Wo, Wo, Wo, Wo, Wo, Ww, Ww, Ww, Ww, Ww, Ww, Ww, Ww, Ww, Ww, Wo, Ww, Ww, Gg, Gg, Gg, Ss, Gg, Ss, Ww, Ss, Ww, Ww, Gs^Vc, Ss, Ss, Gg, Ss, Ss, Gg, Gs, Ss, Gs, Gs, Gg, Hh, Mm, Gs, Gs, Mm, Mm, Mm^Xm, Mm^Xm, Mm^Xm, Mm^Xm, Mm, Mm, Mm, Gd, Gs, Hhd, Gd, Gd, Rd, Rd, Hhd, Hhd, Gs, Gd
Hhd, Ds, Ww, Ww, Ww, Wo, Wo, Wwr, Wo, Wo, Wo, Wo, Wo, Wo, Wo, Wo, Wo, Wo, Wo, Wo, Wo, Ww, Wo, Ww, Ww, Wo, Ww, Ww, Ww, Wwf, Gg, Gg, Gs^Vc, Gg, Ww, Wwf, Gg, Wo, Ss, Gg, Gg, Ss, Gg, Gg, Gg, Gg, Gg, Gs, Gs, Gs, Gg, Hh, Hh, Mm, Gs, Mm, Mm, Mm, Mm^Xm, Mm, Hh, Mm^Xm, Mm^Xm, Mm, Mm, Hhd, Hhd, Gd^Es, Gd, Rd, Gd, Hhd, Md, Md, Gd^Es, Md
Gd, Gd, Ww, Ww, Wo, Wo, Ww, Wo, Wo, Wo, Wo, Wo, Wo, Wo, Wo, Wo, Wo, Wo, Wo, Wo, Wo, Wo, Wo, Ww, Wo, Ww, Ww, Ww, Ww, Wwf, Ds, Ss, Wwf, Ww, Wwf, Ss, Chs, Khs, Chs, Ss, Ss, Ss, Gg, Ss, Gg, Gg, Gg, Gg, Gs, Gg, Hh, Hh, Hh, Gs, Hh, Mm, Hh, Mm^Xm, Hh, Mm, Hh, Mm^Xm, Mm^Xm, Mm, Gd, Hhd, Gs, Hhd, Gd, Rd, Hhd, Hhd, Md, Hhd, Hhd, Gd
Ww, Ww, Ww, Wo, Wo, Wo, Wo, Wo, Wo, Wo, Wo, Wo, Wo, Wo, Wo, Wo, Wo, Wo, Wo, Wo, Wo, Wo, Wo, Wo, Wo, Ww, Ww, Ww, Wo, Ww, Ds, Ds, Ww, Ww, Ss, Ss, Ss, Chs, Ss, Gg, Gg, Gg, Ss, Gg^Efm, Ss, Gg, Gg, Gs, Gs, Gs^Vh, Gg, Gg, Gs, Gs, Hh, Hh, Gs, Mm^Xm, Mm^Xm, Mm^Xm, Mm^Xm, Hhd, Hh, Hh, Hhd, Hhd, Hhd, Hhd, Rd, Rd, Gd, Hhd, Md, Hhd, Md, Gd
Gd, Wo, Wo, Wo, Ww, Wo, Wo, Wo, Wo, Wo, Wo, Wo, Wo, Wo, Wo, Wo, Wo, Wo, Wo, Wo, Wo, Wo, Wo, Wo, Wo, Wo, Wo, Ww, Ww, Ww, Wo, Ww, Wo, Ss, Ss, Ww, Ss, Ss, Gg, Ss, Ss, Ss, Ss, Gg, Gg, Gg, Gg, Gs, Gs, Gg, Gg, Gg, Gg, Gg, Gs, Gs, Gs^Es, Hh, Hh, Mm^Xm, Mm, Mm^Xm, Mm^Xm, Mm, Mm, Gs, Gd, Rd, Gd, Hhd, Gd, Gd^Es, Md, Md^Xm, Md, Hhd
Hhd, Gd, Ds, Ww, Ww, Ww, Ww, Ww, Wo, Wo, Wo, Wo, Wo, Wo, Wo, Wo, Wo, Wo, Wo, Wo, Wo, Wo, Wo, Ww, Wo, Wo, Wo, Ww, Wo, Wo, Ww, Ww, Ds, Ss, Ss, Gg, Ss, Gg, Ss, Ss, Ww, Gg, Gg, Gg, Gg, Gg, Gg, Gg, Gs, Gs, Ds, Gg, Ds, Gs, Gg, Gg, Gg, Gs, Hh, Hh, Hh^Vhh, Mm^Xm, Mm, Mm^Xm, Mm, Hhd, Gs, Rd, Hhd, Hhd, Hhd, Md, Hhd, Md^Xm, Md, Hhd
Gd, Gd, Hh, Gs, Ww, Ww, Ww, Ww, Wo, Wo, Wo, Wo, Wo, Wo, Wo, Wo, Wo, Wo, Wo, Wo, Wo, Wo, Wo, Wo, Wo, Wo, Wo, Wo, Wo, Ww, Ww, Ww, Ww, Gg, Ss, Ss, Ss, Ss, Ww, Gg, Ww, Ss, Gg, Ds, Gg, Ds, Ds, Gs, Ds, Ds, Ww, Ds, Wo, Ds, Gs, Gs, Gs, Gs, Gs, Gs, Hh, Mm, Mm, Mm^Xm, Mm, Hhd, Gd, Rd, Hhd, Md, Hhd, Md, Mm^Xm, Mm^Xm, Mm^Xm, Mm^Xm
Hhd, Hhd, 5 Hhd, Ds, Ww, Ww, Ww, Wo, Ww, Wo, Wo, Wo, Wo, Wo, Wo, Wo, Wo, Wo, Wo, Wo, Wo, Wo, Wo, Wo, Wo, Wo, Wo, Ww, Wo, Ww, Ww, Ww, Wo, Ww, Ww, Gg, Ss, Ww, Wo, Ww, Wo, Ww, Wo, Ww, Ww, Ww, Ds, Ww, Ww, Ds, Wo, Wo, Ww, Ds, Gs, Gs, Gg, Gs, Gs, Hh, Gs, Hh, Hh, Mm^Xm, Hh, Hh, Gd, Re, Hhd, Hhd, Mm^Xm, Mm^Xm, Hh, Hh, Hh, Hh
Gs, Gd, Gs, Gs, Ww, Ww, Ww, Ww, Wo, Wo, Wo, Wo, Wo, Wo, Wo, Wo, Wo, Wo, Wo, Wo, Wo, Wo, Wo, Wo, Wo, Wo, Wo, Wo, Wo, Wo, Wo, Wo, Ww, Ww, Ww, Ss, Ww, Ss, Wo, Wo, Wo, Wo, Ww, Ww, Wo, Ww, Ww, Wo, Wo, Wo, Wo, Wo, Wo, Wo, Ww, Gs, Gs, Gs, Gg, Gs, Ch, Gs, Gs, Hh, Rr, Hhd, Rd, Rd, Hhd, Mm^Xm, Hh, Mm, Ww, Hh, Ww, Ww
Wo, Wo, Ww, Ww, Wo, Wo, Wo, Ww, Wo, Wo, Wo, Wo, Wo, Wo, Wo, Wo, Wo, Wo, Wo, Wo, Wo, Wo, Wo, Wo, Wo, Wo, Wo, Wo, Wo, Wo, Wo, Wo, Wo, Ww, Wo, Ww, Ww, Ww, Wo, Wo, Wo, Wo, Wo, Wo, Wo, Wo, Wo, Wo, Wo, Wo, Wo, Wo, Wo, Wo, Ww, Ch, Gs, Gs, Rr, Ch, Rrc, Gs, Rr, Rp, Md, Rp, Hhd, Hhd, Mm^Xm, Mm^Xm, Wo, Wo, Wo, Wo, Wo, Ww
Wo, Hh, Wo, Wo, Wo, Wo, Wo, Wo, Wo, Wo, Wo, Wo, Wo, Wo, Wo, Wo, Wo, Wo, Wo, Wo, Wo, Wo, Wo, Wo, Wo, Wo, Ww, Ww, Ww, Wo, Wo, Wo, Wo, Wo, Wo, Wo, Wo, Wo, Wo, Wo, Wo, Wo, Wo, Wo, Wo, Ww, Wo, Wo, Wo, Wo, Wo, Wo, Wo, Wo, Wo, Ch, Rr, Rp, Rrc, Rrc, Rrc, Rr, Hh, Hh, Mm, Mm^Xm, Hh, Mm^Xm, Hh, Hh, Wo, Ww, Wo, Wo, Wo, Wo
Wo, Wo, Ww, Ww, Wo, Wo, Wo, Wo, Wo, Wo, Wo, Wo, Wo, Wo, Wo, Wo, Wo, Wo, Wo, Wo, Wo, Wo, Wo, Wo, Wo, Wo, Ww, Ww, Ww, Ww, Wwf, Ww, Wo, Wo, Wo, Wo, Wo, Wo, Wo, Wo, Wo, Wo, Wo, Wo, Wo, Ww, Ww, Wo, Wo, Wo, Wo, Wo, Wo, Wo, Wo, Ww^Bw/, Rrc, Rrc, Gs, Rrc, Ch, Gs, Gs, Hh, Hh, Mm, Hh, Mm^Xm, Wo, Wo, Wo, Wo, Wo, Wo, Wo, Ww
Wo, Wo, Wo, Wo, Wo, Wo, Wo, Wo, Wo, Wo, Wo, Wo, Wo, Wo, Wo, Wo, Wo, Wo, Wo, Wo, Wo, Wo, Wo, Wo, Wo, Wo, Gg, Gs, Gg, Gg, Ww, Ww, Ww, Wo, Wo, Wo, Wo, Wo, Wo, Wo, Wo, Wo, Wo, Wo, Wo, Ww, Ww, Wo, Ww, Wo, Wo, Wo, Wo, Wo, Wo, Ww^Bw/, Ww, Ch, Gg, Ch, Ch, 7 Kh, Gs, Gs, Gs^Es, Mm, Hh, Hh, Wo, Wo, Wo, Wo, Ww, Wo, Wo, Wo
Wo, Wo, Wo, Wo, Wo, Wo, Wo, Wo, Wo, Wo, Wo, Wo, Wo, Wo, Wo, Wo, Wo, Wo, Wo, Wo, Ww, Wo, Wo, Wwf, Ch, Ww, Ww, Gg, Gs, Ww, Ww, Ww, Ww, Wo, Wo, Wo, Wo, Wo, Wo, Wo, Wo, Wo, Wo, Wo, Wo, Wo, Wo, Wo, Wo, Wo, Wo, Wo, Wo, Wo, Wo, Wo, Ww, Gs, Gs, Ch, Gg, Rb, Gg, Gs, Gg, Hh, Wo, Wo, Wo, Wo, Wo, Wo, Wo, Wo, Wo, Wo
Wo, Wo, Wo, Wo, Wo, Wo, Wo, Wo, Wo, Wo, Wo, Wo, Wo, Wo, Wo, Wo, Wo, Wo, Wo, Ww, Ww, Ww, Ww, Ds, Gg, Ww, Wo, Gg, Gg, Gs, Gs, Ww, Ww, Wo, Wo, Wo, Ww, Wo, Wo, Wo, Wo, Wo, Wo, Wo, Wo, Wo, Wo, Wo, Wo, Wo, Wo, Wo, Ww, Wo, Ww, Ww, Ww, Ds, Gg, Gs, Wwf, Rb, Rb, Gg, Hh, Hh, Wo, Wo, Wo, Wo, Wo, Wo, Wo, Ww, Ww, Ww
Wo, Wo, Wo, Wo, Wo, Wo, Wo, Wo, Wo, Wo, Wo, Wo, Wo, Wo, Wo, Wo, Wo, Wo, Ww, Ww, Ww, Ww, Ds, Ds, Gg, Ww, Wo, Wo, Wo, Gg, Gs, Gs, Wo, Ww, Ww, Wo, Ww, Ww, Ww, Wo, Ww, Wo, Wo, Wo, Wo, Wo, Wo, Wo, Wo, Wo, Wo, Ww, Ww, Ww, Ww, Ww, Ww, Hh, Ww, Ww, Wwf, Ww, Ww, Rb, Wo, Wo, Wo, Wo, Wo, Wo, Ww, Ww, Gg, Gg, Gg, Ww
Wo, Wo, Wo, Wo, Wo, Wo, Wo, Wo, Wo, Wo, Wo, Wo, Wo, Wo, Ww, Ww, Ww, Ww, Ww, Wo, Wo, Ww, Gg, Gs, Gs, Ww, Ww, Ww, Wo, Gg, Gg, Ds, Gs, Gg, Wo, Ww, Wo, Ww, Ww, Ww, Ww, Wo, Wo, Wo, Wo, Wo, Wo, Wo, Wo, Wo, Ww, Ww, Wo, Ww, Ds, Ss, Ww, Ww, Ww, Ww, Mm, Wwf, Ww, Wo^Bw|, Wo, Wo, Wo, Wo, Wo, Wo, Wo, Gg^Efm, Ww, Gg^Efm, Ww, Ww
Wo, Wo, Wo, Wo, Wo, Wo, Wo, Wo, Wo, Wo, Wo, Wo, Wo, Ww, Ww, Ww, Wo, Ww, Ww, Ww, Gs, Ww, Ww, Gg, Gs, Ww, Ww, Ww, Hh, Gs^Vc, Gs, Gs, Gs, Gg, Gg, Gs, Gg, Wo, Ch, Ww, Ww, Ww, Wo, Wo, Wo, Wo, Wo, Wo, Wo, Wo, Wo, Wo, Ww, Ww, Wo, Ww, Wo, Ss, Gg, Hh, Gg, Wwf, Ww, Wo^Bw|, Ss, Ss, Ww, Wo, Wo, Wo, Ww, Ww, Wo, Ww, Mm, Gg
Wo, Wo, Wo, Wo, Wo, Wo, Wo, Wo, Wo, Wo, Wo, Wo, Wo, Wo, Ww, Ww, Ww, Ww, Ww, Ww, Ww, Gs, Gs, Gg, Gg, Gg, Wo, Gg, Gg, Hh, Gs, Hh, Hh, Gs, Gs, Gs, Gs, Gg, Ch, Ww, Ww, Ww, Wo, Wo, Wo, Wo, Wo, Wo, Wo, Wo, Ww, Ww, Wo, Ww, Wo, Wo, Mm, Ss, Ss, Gg, Gg, Ww, Wwf, Rb, Rb, Ss, Mm, Ww, Ww, Wo, Gg, Gg^Efm, Hh, Wo, Mm, Mm
Wo, Wo, Wo, Wo, Wo, Wo, Wo, Wo, Wo, Wo, Wo, Wo, Wo, Wo, Ww, Ww, Ww, Ww, Ww, Ww, Ww, Gs, Gs, Gs, Gs, Gg, Gs, Gs, Hh, Gs, Hh, Hh, Gs, Gs, Hh, Gs, Gs, Gs, Rb, Ww^Bw/, Ww^Bw/, Ww, Ww, Wo, Ww, Wo, Wo, Wo, Wo, Wo, Wo, Wo, Wo, Wo, Wo, Wo, Mm, Gs^Vc, Gg, Ss, Wwf, Ww, Ww, Ss, Rb, Ss, Mm^Xm, Mm, Gg, Gs, Mm, Mm, Mm, Wo, Hh, Hh
Wo, Wo, Wo, Wo, Wo, Wo, Wo, Wo, Wo, Wo, Wo, Wo, Wo, Ww, Ww, Ww, Ww, Ww, Wo, Ww, Wo, Ww, Gs, Gs, Hh, Gs, Gs, Gs, Wo, Hh, Hh, Gs, Gs, Gs^Es, Hh, Gs, Gs, 1 Gs, Gg, Rb, Ww, Ww, Ww, Wo, Ww, Ww, Ww, Wo, Wo, Wo, Wo, Wo, Wo, Wo, Wo, Wo, Hh, Mm, Hh, Gg, Ss, Wwf, Ww, Gg, Rb, Ss, Gg, Mm^Xm, Mm^Xm, Mm, Mm^Xm, Ms, Ww, Wo, Mm, Mm
Wo, Wo, Wo, Wo, Wo, Wo, Wo, Wo, Wo, Wo, Ww, Ww, Ww, Ww, Ww, Ww, Ww, Gg, Gg, Hh, Hh^Fds, Ww, Gg, Hh, Hh, Gs, Gg, Gg, Ww, Hh, Gs, Gs, Gs, Hh, Gs, Gs, Gs, Gs, Gs, Ch, Ww, Ww, Ww, Wo, Wo, Wo, Wo, Wo, Wo, Wo, Wo, Wo, Ww, Wo, Wo, Wo, Wo, Mm, Mm, Ss, Gg, Wwf, Wwf, Wwf, Wwf, Gg, Ww, Gg, Ss, Mm^Xm, Mm, Mm^Xm, Mm^Xm, Mm, Mm, Mm
Wo, Wo, Wo, Wo, Wo, Wo, Wo, Wo, Wo, Ww, Wo, Wo, Wo, Ww, Ww, Wo, Ww, Ds, Ds, Gg, Gs, Gs^Vc, Gs, Mm, Gs^Es, Gs, Gs, Ww, Ds, Gg, Gg, Gs, Hh, Hh, Hh, Gs, Gs, Gg, Gg, Ch, Ww, Ww, Ww, Wo, Wo, Wo, Wo, Wo, Wo, Wo, Wo, Wo, Wo, Wo, Wo, Wo, Hh, Md, Mm, Gg, Ss, Gg, Ww, Ww, Rb, Ww, Ww, Ss, Gg, Gg^Efm, Ss, Gg, Mm, Mm^Xm, Mm^Xm, Mm
Wo, Wo, Wo, Wo, Wo, Wo, Wo, Wo, Wo, Wo, Wo, Ww, Wo, Wo, Ww, Ww, Ww, Wo, Gg, Gs, Gs, Gs, Gs, Gg, Gs, Gs, Wo, Wo, Gs, Hh, Gg, Gs^Vc, Gg, Hh, Gs, Gs, Hh, Ds, Hh, Wo, Ww, Ww, Ww, Ww, Ww, Wo, Wo, Wo, Wo, Wo, Wo, Wo, Wo, Wo, Ww, Wo, Hh, Md, Md, Mm, Ss, Sm, Wwf, Ww, Ss, Rb, Ww, Ww, Ss, Ss, Ss, Ss, Ss, Mm, Mm, Mm^Xm
Wo, Wo, Wo, Wo, Wo, Wo, Wo, Wo, Wo, Wo, Wo, Ww, Wo, Ww, Ww, Ww, Wo, Wo, Ds, Gg, Gs, Gs^Es, Gs, Gs, Gg, Ww, Gg, Hh, Gs^Es, Hh, Gg, Gg, Gs, Gs, Gs, Gs, Hh, Wo, Wo, Wo, Wwf, Ww, Ww, Ww, Ww, Ww, Wo, Wo, Wo, Wo, Wo, Wo, Wo, Wo, Wo, Wo, Wo, Wo, Md, Mm, Ss, Gg, Wwf, Ww, Ss, Rb, Rb, Ww, Ww, Ss, Ss, Ss, Ss, Ss, Ww^Ewl, Mm
Wo, Wo, Wo, Wo, Wo, Wo, Wo, Wo, Wo, Wo, Wo, Wo, Wo, Ww, Ww, Ww, Wo, Wo, Ww, Gg, Gs, Gs, Gs, Gs, Ww, Ww, Gs, Gs, Hh, Gs, Gg, Gs, Gs, Gs, Gs, Gs, Gg, Wo, Ww, Ww, Ww, Ww, Ww, Ww, Ww, Wo, Ww, Wo, Wo, Wo, Wo, Wo, Wo, Wo, Ww, Wo, Wo, Wo, Hh, Mm, Ss, Gg, Wwf, Wwf, Gg, Gs^Vc, Ss, Rb, Ss, Ww, Ww, Ss, Gg, Ss, Ss, Mm
Wo, Wo, Wo, Wo, Wo, Wo, Wo, Wo, Wo, Ww, Ww, Ww, Wo, Ww, Ww, Ww, Wo, Ww, Ww, Gg, Gg, Gs, Ww, Wo, Wo, Wo, Ww, Gs, Gs, Gs, Gg, Ww, Ww, Ds, Gs, Gs, Gs, Wo, Ww, Ww, Ww, Wo, Ww, Ww, Ww, Wo, Wo, Wo, Wo, Wo, Ww, Ww, Ww, Ww, Wo, Wo, Wo, Wo, Hh, Mm, Mm, Ss, Ww, Ww, Wwf, Ss, Gg, Rb, Ss, Ww, Ww, Gg^Efm, Ww, Sm, Ss, Mm
Wo, Wo, Wo, Wo, Wo, Wo, Wo, Wo, Wo, Wo, Wo, Ww, Wo, Wo, Ww, Wo, Ww, Ww, Ch, Gg, Hh, Gs, Ww, Wo, Wwf, Wo, Ww, Gs, Gg, Gg, Gs, Gg, Wo, Ds, Gs, Gs, Ww, Wo, Ww, Ww, Ww, Ww, Ww, Ww, Wo, Wo, Wo, Wo, Wo, Wo, Ww, Ww, Ww, Ww, Ww, Ww, Ww, Wo, Wo, Hh, Mm, Ss, Ww, Wwf, Ww, Ss, Gg, Rb, Rb, Ss, Ss, Ww, Ss, Ww, Ss, Gg
Wo, Wo, Wo, Wo, Wo, Wo, Wo, Wo, Wo, Wo, Wo, Wo, Wo, Wo, Wo, Ww, Ww, Ww, Wo, Ww, Wo, Gs, Wo^Bw\, Wo, Ww, Gs, Gs^Vc, Ww, Gs, Gs, Gs, Gg, Wo, Wo, Gg, Gs, Ww, Wo, Ww, Ww, Ww, Ww, Wo, Wo, Wo, Wo, Wo, Wo, Wo, Wo, Ww, Ww, Ww, Ww, Gg, Ww, Ww, Ww, Mm, Mm, Hh, Hh, Hh, Ww, Gg, Ww, Ss, Ss, Ww, Rb, Rb, Ss, Ss, Ww, Ss, Ss
Wo, Wo, Wo, Wo, Wo, Wo, Wo, Wo, Wo, Wo, Wo, Wo, Wo, Wo, Ww, Ww, Wo, Ww, Ww, Wo, Ww, Wo, Ww, Gs, Gs, Gs, Gs, Gs, Gs, Gs, Gs, Ww, Ww, Ww, Wo, Wwf, Gs, Gg, Ww, Ww, Ww, Wo, Wo, Wo, Wo, Wo, Wo, Wo, Wo, Wo, Wo, Ww, Ww, Ww, Gs, Gs, Gs, Hh, Mm, Hh, Ww, Gg, Ww, Wwf, Ss, Gg, Ww, Ss, Ww, Ss, Ss, Rb, Rb, Ww, Ss, Ss
Wo, Wo, Wo, Wo, Wo, Wo, Wo, Wo, Wo, Wo, Wo, Wo, Wo, Wo, Wo, Wo, Wo, Wo, Ww, Ww, Wo, Ww, Wo, Ds, Gs, Gs, Gs, Gs, Ds, Gs^Es, Hh, Gs, Gs, Gs, Gs, Ww, Gg, Wo, Ww, Wo, Wo, Wo, Wo, Wo, Wo, Wo, Wo, Wo, Wo, Wo, Wo, Wo, Ww, Ww, Ww, Wwf, Gs^Vc, Gg, Gs, Hh, Ww, Ww, Ww, Gg, Ss, Ww, Ss, Ss, Ss, Sm, Ss, Ss, Gs^Vc, Ww^Bw\, Rb, Ss
Wo, Wo, Wo, Wo, Wo, Wo, Wo, Wo, Wo, Wo, Wo, Wo, Wo, Wo, Ww, Ww, Wo, Ww, Wo, Ww, Wo, Wo, Ww, Ds, Gs, Gs, Gs, Ww, Ds, Hh, Gs, Gs, Gs, Gs, Gs, Gs, Hh, Gg^Efm, Gs, Wo, Wo, Wo, Wo, Wo, Wo, Wo, Ww, Wo, Wo, Wo, Wo, Wo, Wo, Ww, Ww, Ww, Gg, Gs, Gg, Ww, Ww, Ww, Ww, Wwf, Wwf, Ww, Gg, Ss, Ww, Ss, Gg, Ss, Ss, Ww, Ss, Rb
Wo, Wo, Wo, Wo, Wo, Wo, Wo, Wo, Wo, Wo, Wo, Wo, Wo, Wo, Wo, Ww, Wo, Wo, Ww, Wo, Ww, Ww, Hh, Gs, Gs, Gs^Es, Gs, Gs, Gs, Gs, Ds, Gs, Gs, Gs, Hh, Ww, Ww, Gs, Gg, Gg, Gs, Gg, Gs, Wo, Ww, Wo, Ww, Wo, Wo, Wo, Wo, Wo, Wo, Ww, Ww, Ww, Ww, Ww, Ww, Wwf, Chw, Wo, Ww, Ww, Ww, Ww, Ss, Ss, Ss, Gg^Efm, Ss, Gg, Ss, Ww, Gg, Ss
Wo, Wo, Wo, Wo, Wo, Wo, Wo, Wo, Wo, Wo, Wo, Wo, Wo, Wo, Wo, Wo, Wo, Ww, Wo, Wo, Wo, Wo, Wo, Gs, Ch, Gs, Ww, Gs, Gs, Gs, Wo, Wo, Wo, Ww, Ww, Ww, Ww, Ww, Hh, Gs, Gs, Gs, Gs^Es, Gs, Ww, Ww, Wo, Wo, Wo, Wo, Wo, Ww, Ww, Ww, Ww, Wwr, Gg, Ww, Ww, Chw, Khw, Chw, Ww, Wwf, Ds, Ww, Ds, Gg, Ss, Wo, Rb, Ds, Ww, Ww, Gs, Gg
Wo, Wo, Wo, Wo, Wo, Wo, Wo, Wo, Wo, Wo, Wo, Wo, Wo, Wo, Wo, Wo, Ww, Wo, Wo, Wo, Wo, Wo, Wo, Wo, Ww, Wo, Ww, Wwf, Wo, Wo, Wo, Wo, Ww, Wo, Ww, Ww, Ww, Ww, Ww, Ds, Gs, Gs, Gs, Gs, Gg, Wwf, Ww, Wo, Wo, Ww, Ww, Ww, Ww, Ww, Ww, Ww, Wo, Ww, Ww, Ww, Wo, Ww, Wwf, Gg, Gs, Ww, Wo, Ds, Ww, Ss, Ss, Gg, Gs, Ww, Ds, Gs
Wo, Wo, Wo, Wo, Wo, Wo, Wo, Wo, Wo, Wo, Wo, Wo, Wo, Wo, Wo, Ww, Wo, Wo, Wo, Wo, Wo, Wo, Wo, Wo, Ww, Wo, Ww, Wo, Wo, Wo, Wo, Wo, Wo, Wo, Wo, Ww, Wo, Ww, Wo, Ch, Ww, Gs, Wo, Gs, Ww, Ww, Ww, Wo, Wo, Wo, Wo, Ww, Ww, Ww, Ww, Ww, Wwr, Ww, Wwf, Wwf, Ds, Wwf, Ww, Gs^Vc, Ds, Wwf, Ww, Ww, Ww, Ww, Wwf, Gg, Wwf, Ww, Wo, Ds
Wo, Wo, Wo, Wo, Wo, Wo, Wo, Wo, Wo, Wo, Wo, Wo, Wo, Wo, Wo, Wo, Wo, Wo, Wo, Wo, Wo, Wo, Wo, Wo, Wo, Ww, Wo, Wo, Wo, Wo, Wo, Wo, Wo, Wo, Wo, Ww, Ww, Wo, Wo, Ww, Ww, Ww, Wo, Ww, Ww, Ww, Ww, Wo, Wo, Wo, Ww, Ww, Ww, Ww, Wwr, Ww, Ww, Wwr, Ds, Ds, Wwf, Wwf, Ww, Ds, Ww, Wwf, Ww, Ww, Wo, Ww, Ww, Wwf, Wo, Ww, Wo, Wo
Wo, Wo, Wo, Wo, Wo, Wo, Wo, Wo, Wo, Wo, Wo, Wo, Wo, Wo, Wo, Wo, Wo, Wo, Wo, Wo, Wo, Wo, Wo, Wo, Wo, Wo, Wo, Wo, Wo, Wo, Wo, Wo, Wo, Wo, Wo, Wo, Wo, Ww, Wo, Ww, Wo, Wo, Wo, Ww, Wo, Wo, Wo, Ww, Wo, Wo, Wo, Ww, Ww, Ww, Ww, Ww, Ww, Wo, Wo, Ww, Wwf, Wwf, Wwf, Ds, Ds, Ww, Ds, Ww, Wo, Wo, Ww, Wo, Wo, Ww, Wo, Wo
Wo, Wo, Wo, Wo, Wo, Wo, Wo, Wo, Wo, Wo, Wo, Wo, Wo, Wo, Wo, Wo, Wo, Wo, Wo, Wo, Wo, Wo, Wo, Wo, Wo, Wo, Wo, Wo, Wo, Wo, Wo, Ww, Wo, Wo, Wo, Wo, Wo, Wo, Wo, Wo, Wo, Wo, Wo, Wo, Wo, Wo, Wo, Wo, Wo, Wo, Wo, Ww, Ww, Wo, Wo, Ww, Ww, Ww, Ww, Ww, Gg, Ww, Wo, Ds, Ds, Ww, Ww, Wo, Ww, Wo, Wo, Wo, Ww, Wo, Wo, Wo
Wo, Wo, Wo, Wo, Wo, Wo, Wo, Wo, Wo, Wo, Wo, Wo, Wo, Wo, Wo, Wo, Wo, Wo, Wo, Wo, Wo, Wo, Wo, Wo, Wo, Wo, Wo, Wo, Wo, Wo, Wo, Wo, Wo, Wo, Wo, Wo, Wo, Wo, Wo, Wo, Wo, Wo, Wo, Wo, Wo, Wo, Wo, Wo, Wo, Wo, Ww, Ww, Ww, Wo, Ww, Ww, Wo, Ww, Wo, Wwf, Wo, Wo, Ds, Ds, Wo, Ww, Ww, Ww, Wo, Wo, Ww, Ww, Wo, Wo, Wo, Wo
Wo, Wo, Wo, Wo, Wo, Wo, Wo, Wo, Wo, Wo, Wo, Wo, Wo, Wo, Wo, Ww, Hh, Wo, Wo, Wo, Wo, Wo, Wo, Wo, Wo, Wo, Wo, Wo, Wo, Wo, Wo, Wo, Wo, Wo, Wo, Wo, Wo, Wo, Wo, Wo, Wo, Wo, Wo, Wo, Wo, Wo, Wo, Wo, Wo, Ww, Wo, Wo, Wo, Ww, Wo, Ww, Ww, Ww, Wo, Wo, Ww, Wo, Gs, Ww, Wo, Wo, Ww, Wwr, Ww, Wo, Wo, Ww, Wwr, Wo, Wo, Wo
Wo, Wo, Wo, Wo, Wo, Wo, Wo, Wo, Wo, Wo, Wo, Wo, Wo, Wo, Wo, Mm, Wo, Hh, Wo, Wo, Wo, Wo, Wo, Wo, Wo, Wo, Wo, Wo, Wo, Wo, Wo, Wo, Wo, Wo, Wo, Wo, Wo, Wo, Wo, Wo, Wo, Wo, Wo, Wo, Wo, Wo, Wo, Wo, Wo, Wo, Wo, Wo, Ww, Ww, Ww, Wo, Ww, Ww, Ww, Ww, Ww, Wo, Wo, Ww, Ww, Ww, Wo, Ww, Wo, Ww, Wo, Ww, Wo, Wo, Wo, Wo
Wo, Wo, Wo, Wo, Wo, Wo, Wo, Wo, Wo, Wo, Wo, Wo, Wo, Wo, Wo, Hh, Wo, Wo, Wo, Wo, Wo, Wo, Wo, Wwr, Wwr, Wo, Wo, Wo, Wo, Wo, Wo, Wo, Wo, Wo, Wo, Wo, Wo, Wo, Wo, Wo, Wo, Wo, Wo, Wo, Wo, Wo, Wo, Wo, Wo, Wo, Wo, Ww, Ww, Ww, Wo, Ww, Wo, Wo, Ww, Wo, Ww, Ww, Ww, Ww, Wwr, Ww, Ww, Ww, Wo, Ww, Wo, Wo, Wo, Wo, Wo, Wo
Wo, Wo, Wo, Wo, Wo, Wo, Wo, Wo, Wo, Wo, Wo, Wo, Wo, Wo, Wo, Wo, Wo, Wo, Wo, Wo, Wo, Wo, Wo, Ww, Wo, Wo, Wo, Wo, Wo, Wo, Wo, Wo, Wo, Wo, Wo, Wo, Wo, Wo, Wo, Wo, Wo, Wo, Wo, Wo, Wo, Wo, Wo, Wo, Wo, Wo, Wo, Wo, Wo, Wo, Wo, Wo, Wo, Wo, Ww, Ww, Ww, Wo, Wo, Ww, Wo, Wo, Wo, Ww, Ww, Wo, Wo, Ww, Wo, Wo, Wo, Wo
Wo, Wo, Wo, Wo, Wo, Wo, Wo, Wo, Wo, Wo, Wo, Wo, Wo, Wo, Wo, Wo, Wo, Wo, Wo, Wo, Wo, Wo, Wo, Wo, Wo, Wo, Wo, Wo, Wo, Wo, Wo, Wo, Wo, Wo, Wo, Wo, Wo, Wo, Wo, Wo, Wo, Wo, Wo, Wo, Wo, Wo, Wo, Wo, Wo, Wo, Wo, Wo, Wo, Wo, Wo, Wo, Wo, Wo, Ww, Wo, Wo, Wo, Ww, Wo, Ww, Wo, Wo, Wo, Ww, Wo, Wo, Ww, Ww, Wo, Wo, Wo
Wo, Wo, Wo, Wo, Wo, Wo, Wo, Wo, Wo, Wo, Wo, Wo, Wo, Wo, Wo, Wo, Wo, Wo, Wo, Wo, Wo, Wo, Wo, Wo, Wo, Wo, Wo, Wo, Wo, Wo, Wo, Wo, Wo, Wo, Wo, Wo, Wo, Wo, Wo, Wo, Wo, Wo, Wo, Wo, Wo, Wo, Wo, Wo, Wo, Wo, Wo, Wo, Wo, Wo, Wo, Wo, Wo, Wo, Ww, Wo, Wo, Ww, Wo, Wo, Wo, Wo, Wo, Wo, Wo, Wo, Wo, Wo, Ww, Wo, Ww, Wo
