border_size=1
usage=map

Re, Gg, Gs, Gg, Gs, Gg, Gs, Gs, Gs, Gs, Gs, Hh, Mm, Mm, Mm, Mm^Xm, Gs, Mm, Mm, Mm^Xm, Gs, Mm, Mm, Mm, Mm, Gll, Mm, Mm, Mm, Mm, Mm, Mm, Hh, Gg, Hh, Mm, Hh, Gg, Gg, Rb, Rb, Hh, Gg, Hh, Gg, Hh, Hh, Hh, Mm, Mm, Gg, Hh, Mm, Wo, Wo, Hh, Hh, Wo, Wo, Wo, Wo, Wo, Wo, Ww, Ww, Ww
Gs, Re, Gg, Gs, Gs, Gs, Gg, Gs^Es, Gs, Gs, Hh, Mm, Gs, Mm, Mm, Mm^Xm, Hh, Mm, Mm, Mm^Xm, Mm^Xm, Mm, Mm, Mm, Gs, Gll, Mm, Mm, Mm, Mm, Mm, Mm, Mm, Hh, Mm, Mm, Gg, Hh, Gg, Gg, Gg, Rb, Rb, Gg, Hh, Gg, Gg, Hh, Hh, Gg^Efm, Mm, Mm, Hh, Hh, Hh, Wo, Wwf, Wo, Ww, Ww, Wwf, Ww, Ww, Ww, Gg, Gg
Gs, Re, Re, Gs, Gg, Gs, Gs, Gs, Hh, Gs, Mm, Gs, Mm, Mm, Mm, Mm^Xm, Mm^Xm, Gs, Mm, Gs, Mm, Mm^Xm, Hh, Mm, Mm, Gll, Gg, Gg, Mm, Mm, Mm, Mm, Gs, Hh, Mm^Xm, Hh, Hh, Gg^Efm, Gg, Gg, Hh, Hh, Re, Hh, Gg, Gg, Gg, Hh, Hh, Hh, Mm, Hh, Mm, Hh, Hh^Vhh, Mm, Wwf, Ww, Ww, Ss, Ss, Wo, Ww, Ww, Ss, Gg
Gs, Gs, Gs, Re, Re, Gs, Gs, Gs, Gs, Hh, Gs, Mm, Mm, Hh, Mm, Hh, Mm^Xm, Mm^Xm, Mm^Xm, Mm, Mm, Mm^Xm, Hh, Hh, Mm, Gll, Gll, Mm, Mm, Gs, Gs, Mm, Mm, Mm^Xm, Mm, Mm, Mm, Hh, Hh, Gg, Gs, Gg, Re, Gg, Gg, Gg, Gg, Gg, Gg, Gg, Hh, Mm, Gg, Gg, Gg, Ww, Ww, Ww, Wwf, Ss, Ss, Sm, Wo, Gg^Efm, Gg, Ss
Gs, Gs, Gs, Gg, Re, Gs, Gs, Gs, Gs, Hh, Hh^Vhh, Mm, Mm, Gs, Mm, Gs, Mm, Mm, Mm, Mm^Xm, Mm^Xm, Mm^Xm, Hh, Mm^Xm, Mm^Xm, Mm, Re, Mm, Mm, Gs, Mm, Mm, Mm^Xm, Mm^Xm, Hh, Mm, Mm, Gg, Gs, Gg, Gs, Gg, Re, Gs, Hh, Gg, Gs, Gg, Gg, Gg, Gg, Hh, Gg, Gg, Ww, Wwf, Ww, Ww, Ss, Ww, Gg, Gg, Ww, Ss, Wwf, Ww
Gg, Gs, Gs, Gs, Gg, Re, Re, Gs, Gs, Gs, Hh, Mm, Mm, Gs, Mm, Mm, Mm, Gs, Gs, Mm, Mm^Xm, Hh, Gs, Hh, Gs, Mm, Re, Mm, Mm, Mm, Mm^Xm, Mm, Mm^Xm, Mm^Xm, Hh, Gs, Hh, Gs, Mm, Hh, Gs^Es, Gs, Rb, Hh, Gg, Gg, Gs, Gs, Gg, Gg, Gg^Es, Gg, Gg, Gg, Wwf, Wwf, Ww, Ww, Ww, Gg, Wwf, Ss, Ss, Ww, Wo, Ww
Ds, Gs, Gs, Gs, Gs, Gs, Gg, Re, Rb, Gs, Hh, Mm, Mm, Gs, Mm, Hh, Mm, Mm, Hh, Mm, Mm, Mm^Xm, Mm^Xm, Mm, Hh, Mm, Mm, Rp, Mm, Mm^Xm, Mm, Mm^Xm, Mm, Hh, Hh, Mm, Gg, Mm, Hh^Vhh, Gs, Gs, Gs, Hh, Rb, Rb, Gs, Gs, Gg, Gg, Gg, Gg, Gg, Gg, Wwf, Ww, Ww, Wwf, Wwf, Gs^Vc, Ww, Wwf, Wwf, Ss, Ss, Ss, Gg
Ww, Ds, Ds, Gs, Gg, Gs, Gs, Gg, Re, Gs, Hh, Hh, Hh, Mm, Hh, Mm, Mm, Mm, Mm, Mm, Hh, Mm, Mm, Mm^Xm, Mm, Mm, Rp, Re, Hh, Hh, Mm, Mm, Hh, Mm, Ms, Hh, Mm, Hh, Mm, Hh, Gs, Hh, Hh, Gs, Gs, Rb, Rb, Gg, Gg, Gg, Gg, Gg, Ww, Ww, Ww, Ww, Gs^Vc, Gg, Ss, Gs^Vc, Gg, Ss, Sm, Ss, Ss, Gg
Ww, Ww, Ds, Gs, Gs, Gs, Gg, Gs, Re, Gs, Hh, Gs, Gs, Hh, Hh, Mm, Gs, Hh, Mm, Mm, Mm, Gs, Mm, Mm, Mm, Mm, Re, Mm, Mm^Xm, Mm, Mm^Xm, Mm^Xm, Mm, Ms, Ms, Mm, Hh, Mm, Hh, Gs^Es, Gs, Gg, Gg, Gs, Gg, Gs, Gs, Rb, Rb, Gg, Ww, Wwf, Ww, Wwf, Gg, Ww, Gg, Ww^Ewl, Gg, Gg, Ss, Ss, Ss, Ss, Ss, Ss
Ww, Ww, Ds, Gs^Vc, Gg, Gs, Gs, Gs, Gg, Re, Re, Hh, Gs^Es, Gs, Hh, Mm, Hh, Mm, Hh, Mm, Mm, Mm, Hh, Mm, Mm, Mm, Rp, Hh, Chr, Mm, 1 Khr, Mm^Xm, Hh, Mm, Mm, Wo, Ww, Mm, Wo, Gs, Mm, Gg, Gg, Gs, Gg, Gg, Gg, Gg, Wwf, Wwf, Wwf, Ww, Gg, Gg, Gg, Gg, Gg, Gg, Gg, Ss, Gg^Efm, Gg, Ss, Ss, Gg, Gg^Efm
Ww, Ww, Ww, Ds, Gs, Gs, Gs, Gg, Gs, Gs, Gg, Re, Gs, Gs, Gs, Hh, Hh, Gs, Gs, Mm, Gs, Mm, Mm, Mm, Gs, Mm, Mm, Rp, Chr, Chr, Mm, Mm, Mm, Hh, Mm, Mm, Hh, Ww, Mm, Ww, Gs, Mm, Hh, Gg, Gg, Gs, Gg, Ww, Ww, Rb, Rb, Gg, Gg, Gg, Gg, Gg, Gg, Gg, Ss, Gg, Ss, Gg, Ss, Ss, Ss, Gg
Ww, Ww, Ww, Ds, Ds, Gs, Gs, Gg, Ds, Gs, Gg, Rb, Re, Gs, Hh, Mm, Gs, Hh, Mm, Mm, Hh, Mm, Mm, Mm, Mm, Mm, Mm, Mm, Gs, Gs, Gs, Hh, Mm, Mm, Mm, Mm, Mm, Hh, Hh, Wo, Ww, Hh, Gg, Gg, Gg, Gs, Gg, Ww, Wwf, Gg, Gg, Rb, Rb, Gg, Gg, Gg, Gg, Gg, Ss, Ss, Gg, Ss, Gg, Ss, Ss, Ss
Ww, Ww, Ww, Ds, Ds, Gs, Ds, Ds, Ds, Ds, Ds, Gg, Gs, Re, Re, Gs, Hh, Gs, Hh, Gs, Hh, Gs, Mm, Mm, Gs, Mm, Mm, Hh, Mm, Hh, Gs, Chr, Mm, Mm, Hh, Hh, Hh, Gg, Gg, Hh, Hh, Ww, Gg, Gs, Gg, Gg, Gg, Ww, Ww, Wwf, Wwf, Gg, Gg, Rb, Rb, Gg, Gg, Gg^Es, Gg, Gg, Gg, Gg, Ss, Ss, Hh, Hh
Ww, Ww, Ww, Ww, Ds, Ds, Ww, Ww, Ww, Ds, Ds, Gs, Gs, Gg, Gs, Re, Re, Hh, Gs, Hh, Gs, Hh, Mm, Gs, Mm, Mm, Hh, Hh, Mm, Chr, Mm, Hh, Gs, Gs, Mm, Gs, Hh, Mm, Mm, Mm, Hh, Ww, Gs, Gg, Gg, Gg, Gg, Gg, Ww, Wwf^Es, Gg, Gg, Gg, Gg, Gg, Rb, Rb, Gg, Gg, Gg, Gg, Gg, Gg, Gg, Hh, Mm
Ww, Ww, Ww, Ww, Ds, Ww, Ww, Ww, Ww, Ww, Ds, Gs, Gs, Gs, Gs, Gs, Gs, Re, Re, Gs, Gs, Gs^Es, Gs, Hh, Mm, Mm, Hh, Gs, Hh, Hh, Mm, Mm, Hh, Gs, Hh, Gs, Hh, Mm, Hh, Gg, Mm, Ww, Wwf, Gg, Gg, Gg, Wo, Wo, Ww, Wwf, Gg, Gg, Gg, Gg, Gg, Gg, Gs, Rb, Rb, Gg, Re, Gs, Rb, Gg, Hh, Gg
Ww, Ww, Ww, Ds, Ds, Ww, Ww, Ww, Ww, Ww, Ds, Gg, Gs, Gs, Gs, Gs, Gs, Gs, Re, Gs, Gs, Gs, Gs, Mm, Hh, Mm, Mm, Mm, Mm, Gs, Mm, Mm, Mm, Hh, Gs, Gs, Gs, Mm, Hh, Gg, Gg, Gg, Ww, Ww, Gg, Gg, Wwf, Wo, Gg, Gg^Es, Gg, Gg, Gg, Gg, Gs, Gs, Gs, Gg, Rb, Rb, Gg, Re, Gs, Rb, Re, Re
Ww, Ww, Ww, Ds, Ww, Ww, Wo, Wo, Ww, Ww, Gg, Gs, Gs, Gg, Gs, Gs, Gs, Gg, Rb, Gg, Gs, Gs, Hh, Hh, Gs, Gs, Mm, Mm, Mm, Hh, Hh^Vhh, Mm, Mm, Gg, Gg, Gs, Gs, Mm, Mm, Hh, Mm, Mm, Ww, Ww, Ww, Wwf, Gg, Ww, Gg, Gg, Gg, Gg, Gg, Gg, Gs, Gg, Rb, Re, Gs, Gg, Gs, Gs, Gs, Hh, Hh, Mm
Ww, Ww, Ww, Ww, Ww, Ww, Wo, Wo, Ww, Ww, Ww, Gs, Ds, Gs, Gg, Gs, Gg, Gs, Gg, Rb, Hh, Gs, Hh, Gs, Gs, Mm, Mm, Hh, Gs, Mm, Gs, Gs, Mm, Hh, Gg, Gg, Hh, Gs, Gs, Gs, Gs, Hh, Ww, Wo, Ww, Ss, Ww, Wo, Gg, Gg, Gg, Gs, Gg, Gg, Re, Re, Gs, Gg, Gs, Gs, Gs, Gs, Gs, Hh, Ww, Mm
Wo, Wo, Wo, Ww, Wo, Ww, Ww, Ww, Ww, Ww, Ww, Ds, Ww, Ds, Gs, Gs, Gg, Gs, Gg, Re, Hh, Hh, Mm, Gs, Gs, Gs, Gs, Gs, Gs, Hh, Gs, Mm, Gs, Gg, Gg, Mm, Gg, Gg, Gs, Gs, Gg, Gg, Ww, Wo, Wo, Ww, Gg, Ss, Gg, Gg, Gg, Gg, Rb, Rb, Gg, Gs, Gs, Gs, Gs, Gg, Gd, Gs, Hh, Hh, Mm, Ww
Wo, Wo, Wo, Wo, Wo, Wo, Wo, Ww, Ww, Ww, Wo, Ww, Ww, Ds, Gs, Gs, Gs, Gs, Gs, Re, Re, Gs, Hh, Hh, Gs, Gs, Gs, Gs, Gs, Hh, Hh, Mm, Hh, Hh, Gg, Gs, Gg, Hh, Gg, Gg, Ww, Gg, Ww, Wo, Ww, Ww, Ss, Gg, Gg, Gg, Rb, Rb, Gs, Gg, Gs, Gs, Gg, Gs, Gd, Gd, Gd^Es, Gd, Hh, Gd, Hh, Md
Ww, Wo, Wo, Wo, Wo, Wo, Wo, Ww, Ww, Ww, Wo, Ww, Ww, Ds, Ds, Gg, Gs, Gs, Gs, Gg, Rb, Gs, Gs, Gs, Gs, Gs, Gs, Gs, Gs, Gs, Gg, Hh, Gs, Gs, Gg, Hh, Gg, Gg, Gg, Gg, Ww, Ww, Ww, Ww, Ww, Ww, Ss, Gg, Rb, Rb, Gg, Gs, Gs, Gg, Gg, Gs, Gs, Gs, Gs, Gd, Gs, Gs, Gd, Hh, Gd, Hhd
Wo, Wo, Wo, Wo, Wo, Wo, Wo, Ww, Ww, Wo, Wo, Wo, Wo, Ww, Ww, Gg, Ds, Gs, Gg, Gs, Gg, Re, Gs, Gs, Gs, Gs^Es, Gs, Gs, Gs, Gs, Gs, Gs, Gg, Gg, Gg, Gg, Gg, Gg, Ww, Ww, Ww, Ww, Gg, Gg, Gg, Gg, Rb, Rb, Gg, Gg, Gg, Gs, Gs^Es, Gg, Gs, Gs, Gg, Gs, Gs, Gs, Gs, Gd, Gs, Hh, Hhd, Hhd
Wo, Wo, Wo, Wo, Wo, Wo, Wo, Wo, Ww, Wo, Wo, Wo, Wo, Ww, Ww, Ww, Ww, Ds, Gs, Gs, Gs, Re, Re, Gs, Gs, Gs, Gg, Gg, Gs, Gs, Gs, Gs, Gg, Gg, Gg, Ww, Ww, Ww, Gg, Gg, Ww, Ww, Gg, Gg, Gg, Gg, Rb, Gg, Gg, Gg, Gs, Gs, Gs, Gg, Gs, Gs, Hh, Hh, Hh, Gd, Gd, Gs, Hhd, Hhd, Gd, Hhd
Wo, Wo, Wo, Wo, Wo, Wo, Wo, Wo, Wo, Wo, Wo, Wo, Ww, Wo, Ww, Ww, Ds, Ds, Gs^Vc, Gs, Gs, Gs, Re, Gs, Gs, Gs, Gs, Gs, Gs, Gs, Gg, Gg, Gg, Gg, Ww, Ww, Ww, Gg, Ww, Gg, Wwf, Gg, Gg, Gg, Rb, Rb, Gg, Gg, Gs, Gs, Gg, Gg, Gg, Gs, Hh, Hh, Hh, Gs, Gd, Gd, Gd, Gd, Hhd, Hhd, Md, Md
Wo, Wo, Wo, Wo, Wo, Wo, Wo, Wo, Wo, Wo, Wo, Wo, Wo, Ww, Ww, Ww, Ds, Gs, Gs, Gg, Gs, Gs, Gg, Re, Gg, Gs, Gs, Gg, Gs, Gs, Gg, Gg, Gg, Ww, Wo, Ww, Wwf, Wwf, Gg, Wwf, Gs^Vc, Gg, Rb, Rb, Gg, Gg, Gg, Gs, Gs, Gg, Hh, Hh, Hh, Gs, Gs, Gs, Mm, Hh, Gd, Hhd, Hhd, Gd, Hhd, Hhd, Md, Md
Wo, Wo, Wo, Wo, Wo, Wo, Wo, Wo, Wo, Wo, Wo, Wo, Wo, Wo, Wo, Ww, Ds, Gg, Gs, Gs, Gs, Gs, Gs, Re, Re, Gs, Gg, Gs, Gg, Gg, Gg, Gg, Wwf, Ww, Gg, Wwf, Gg, Ww, Gg, Ss, Gg, Gg, Rb, Gg, Gg, Gs, Gg, Gs, Gs, Hh, Mm, Gs, Hh, Hh, Hh, Hh, Hhd, Gd, Hhd, Hhd, Gd, Gd, Hhd, Md, Hhd, Md
Wo, Wo, Wo, Wo, Wo, Wo, Wo, Wo, Wo, Wo, Wo, Wo, Wo, Wo, Wo, Ww, Ww, Ds, Gs, Gg, Gs, Gs, Gs, Gs, Re, Gs, Gg, Gs, Gg, Gg, Gg, Ww, Gg, Ww, Ww, Ww, Gg, Gg, Gg, Gg, Rb, Rb, Gg, Gg, Gs, Gs, Gg, Gg, Gs, Hh, Hh, Hh, Hhd, Hh, Hhd, Hh, Gs, Gs, Gd, Gd, Hhd, Md, Md, Md, Md, Hhd
Wo, Wo, Wo, Wo, Wo, Wo, Wo, Wo, Wo, Wo, Wo, Wo, Ww, Wo, Wo, Ww, Ww, Ds, Gs, Gg, Gs, Gs, Gs, Gs, Gs, Rb, Gg, Gg, Gg, Gg, Wo, Ww, Ww, Ww, Gg, Gg, Gg, Gg, Rb, Rb, Gg, Gg, Gg, Gg, Gs, Hh, Hh, Hh, Hh, Hh, Gs, Gs, Hhd, Hh, Gd, Gd, Gs, Gd, Md, Gd, Hhd^Vhhr, Hhd, Md, Hhd, Hhd, Hhd
Wo, Wo, Ww, Wo, Ww, Wo, Ww, Wo, Wo, Wo, Wo, Wo, Ww, Wo, Ww, Ww, Ww, Ww, Gg, Gs, Gs, Gs, Gs, Gs, Gg, Re, Gg, Gg, Gg, Ww, Wo, Ww, Gg, Gg, Gg, Gg, Rb, Rb, Gg, Gg, Gg, Gg, Gs, Gg, Gs, Gs, Gs, Hh, Gg, Gs, Gd, Gs, Gd, Gs, Gs, Gs, Gd, Gs, Md, Md, Md, Md, Md, Hhd, Hhd, Hhd
Wo, Wo, Ww, Ww, Wo, Wo, Wo, Ww, Wo, Wo, Wo, Wo, Wo, Wo, Wo, Ww, Ww, Gg, Ds, Gs, Gg, Gs, Gg, Gg, Gg, Rb, Gg, Gg, Wo, Ww, Ww, Gg, Gg, Gg, Gg, Rb, Rb, Gg, Gg, Gg, Gg, Gs, Gs, Gs, Gs, Gs, Hh, Gg, Gs, Gs^Es, Gs, Gd, Gs, Gd, Hhd, Gd, Gd, Hhd, Hhd, Gd, Hhd, Hhd, Md, Hhd, Gd, Gd
Ww, Wo, Ww, Ww, Ww, Wo, Wo, Ww, Wo, Ww, Ww, Ww, Wo, Wo, Wo, Ww, 2 Ww, Ww, Gg, Gg, Gg, Gs, Gg, Gg, Gg, Rb, Gg, Wo, Ww, Ww, Wo, Gg, Gg, Gg, Rb, Rb, Gg, Gg, Gg, Gg, Hh, Gs, Gs, Gs, Gs, Gs, Gs, Gs, Gs, Gg, Gd, Gs, Gs, Gs, Gs, Hh, Gd, Gd, Hhd, Hhd, Md, Hhd, Ms, Md, Hhd, Hhd
Ww, Ww, Ww, Ww, Ds, Ww, Ww, Wo, Ww, Ww, Ds, Wo, Ww, Wo, Ww, Ww, Ww, Ww, Gg, Gg, Ds, Gg, Gg, Gg, Wo, Rb, Wwf, Ww, Ww, Ss, Gg, Ww, Ww^Bw/, Rb, Gg, Gg, Hh, Hh, Hh, Gg, Gs, Gs, Gs, Gs, Gs, Gs, Gs, Gs, Gs, Gg, Gd, Gs, Gs, Gs, Gd^Es, Hhd, Md, Gd, Hhd, Gd^Es, Hhd, Md, Md, Md, Md, Hhd
Ww, Ww, Ds, Ds, Ds, Ww, Ww, Ww, Ds, Ds, Gg^Efm, Ds, Gg, Ww, Ww, Ww, Ww, Gg, Ss, Gg, Wo, Ss, Gg, Wo, Gg, Ww, Ww, Wwf, Gg, Gg, Rb, Rb, Gg, Wo, Ww, Ww, Wwf, Hh^Vhh, Mm, Gs, Hh, Gs, Mm, Gg, Hh, Gs, Gs, Hhd, Hhd, Gd, Gd, Gd, Gd, Gd, Hhd, Gd, Gd, Gd, Md, Hhd, Hhd, Hhd, Hhd, Md, Hhd, Hhd
Ww, Ds, Ww, Gg, Ww, Ds, Ww, Gg, Ww, Gg, Gg, Gg, Ds, Ds, Ds, Ww, Wo, Ww, Ww, Ww, Wo, Wo, Ww, Ww, Ww, Ww, Gg, Rb, Rb, Rb, Gg, Hh, Gg, Gg, Hh, Gg, Hh, Wo, Ww, Hh, Hh, Hh, Hh, Hhd, Hh, Hhd, Gd, Hhd, Gd, Mm, Hhd, Hhd, Gd, Hhd, Gd, Hhd, Hhd, Hhd, Md, Md, Md, Hhd, Md, Hhd, Gd, Gd^Edpp
Ds, Ds, Gg, Ww, Ds, Ww, Ds, Ww, Gg, Ww, Ww, Gg, Gg, Gg, Gg, Gg, Gg, Ww, Ww, Wo, Ww, Ww, Ss, Wo, Gg, Gg, Gg, Rb, Gg, Gg, Hh, Hh, Hh, Hh, Gg, Hh, Mm, Hh, Ww, Hh, Mm, Hh, Hhd, Mm, Hhd, Mm, Hhd, Gd, Hhd, Hhd, Gd, Hhd^Vhhr, Hhd, Hhd, Hhd, Gd, Hhd, Md, Gd, Hhd, Hhd, Md, Hhd, Md, Hhd, Gd
Gg, Gg, Gg, Gg, Gg, Ds, Gg, Gs^Vc, Gg, Gg, Ww, Ww, Ww, Ww, Ww, Gg, Wwf, Ww, Ww, Wwf, Gg, Ww, Gs, Ss, Gs, Gg, Re, Rb, Gg, Gg, Mm, Gg, Hh, Hh, Hh, Hh, Mm, Mm, Mm, Ms, Gd, Hh, Hhd, Md, Hhd, Hhd, Gd, Gs, Gd, Gd, Md, Hhd, Gd, Hhd, Gd, Md, Gd, Hhd, Md, Gd^Es, Hhd, Hhd, Md, Md, Md, Hhd
Gg, Gg, Gg, Gg, Gg^Efm, Gg, Gg, Gg, Gg, Gg, Ds, Ww, Gg, Ww, Ww, Ww, Ww, Ww, Ss, Gg, Gg, Gg, Gg, Gg, Gg, Gs, Re, Gs, Gs, Hh, Mm, Mm, Hh, Hh, Mm, Mm, Md, Md, Md, Hhd, Md, Hhd, Hhd, Hhd, Md, Hhd, Hhd, Gd, Hhd, Gd, Gd, Md, Hhd, Hhd, Md, Hhd, Md, Hhd, Md, Hhd, Md, Hhd, Hhd, Hhd^Vhhr, Hhd, Gd
Gg, Gg, Gg, Gg, Gg, Gg, Gg, Gg, Gg, Ss, Ss, Ss, Gg, Gg, Gg, Ss, Gg, Ss, Gg, Gg, Hh, Gs, Hh, Gs, Gs, Gs, Re, Gs, Hh, Hh, Gs, Hh, Mm, Gs, Mm, Hhd, Md, Md, Md, Gd, Md, Hhd, Md, Md, Md, Gd, Md, Gd, Md, Md, Md, Gd, Hhd, Gd^Edpp, Md, Md, Md, Md, Md, Hhd, Gd, Gd, Gd^Edpp, Gd, Gd, Hhd
