border_size=1
usage=map

Mm, Mm^Xm, Mm^Xm, Mm^Xm, Mm, Hh, Hh, Ke, Ce, Re, Hh, Mm, Mm, Mm, Mm, Gg^Efm, Gg, Mm, Mm, Mm, Mm, Mm, Mm^Xm, Mm^Xm, Hh^Vhh, Hh, Gd, Gd, Hh, Hhd, Hh, Hhd, Gs, Wwf, Gs^Vh, Gd, Gs, Gs, Rd, Re, Gs, Mm, Mm
Mm, Ms^Xm, Mm, Mm, Hh, Mm, Hh, Hh, Hh, Re, Hh, Mm, Hh, Mm, Hh, Mm, Mm, Mm, Mm, Mm, Gg^Efm, Mm^Xm, Ms^Xm, Wo, Mm, Gs, Gs, Hh, Gs, Gd, Gd, Hh, Mm, Re^Gvs, Gs, Gs, Re, Re, Hh, Gs, Gs, Hh, Mm
Mm^Xm, Ms^Xm, Mm, Mm, Hh, Mm, Hh, Gg, Re, Re, Gs, Hh, Mm, Mm, Mm, Gg^Es, Mm, Mm, Mm, Hh, Mm, Ms^Xm, Mm, Mm, Mm, Hh, Hh, Gd, Hhd, Gs, Gd, Gs, Gs, Gs, Gs, Gs, Re, Hhd, Mm, Gs, Gs, Hh, Ms
Mm^Xm, Mm, Hh, Mm, Hh, Mm, Mm, Hh, Rb, Gg, Mm, Mm, Mm, Mm, Mm^Xm, Mm, Ms^Xm, Mm, Mm^Xm, Mm, Ms^Xm, Mm^Xm, Mm, Mm, Mm, Gs, Hh, Hhd, Hh, Gs, Gs, Hh, Gs, Gs, Gs, Gs, Re, Gs, Gs, Hh, Mm, Mm, Mm^Xm
Mm, Hh, Hh^Vhh, Mm, Hh, Hh, Hh, Rb, Mm, Gg, Mm, Mm, Mm^Xm, Mm^Xm, Gg, Ms^Xm, Mm, Mm^Xm, Mm, Mm^Xm, Hh, Mm, Hh, Gs, Hh, Gs, Gs, Hh, Gs, Gd, Gs, Gd, Gs, Gd, Gs, Re, Hh, Hh, Gd^Vhr, Mm, Mm, Mm^Xm, Ms
Gg, Hh, Gg^Efm, Gg, Gg, Gg, Gg, Rb, Gg, Mm, Mm, Mm, Mm^Xm, Hh, Mm, Mm, Mm, Mm, Mm, Mm, Hh, Hh, Hh, Hh, Hh, Hh, Gs, Gs, Hh, Gs, Gd, Gd, Gs, Gs, Re, Re, Gd, Rd, Hh, Mm, Mm^Xm, Mm^Xm, Ms
Hh, Hh, Gg, Gg, Mm, Gg^Efm, Gg, Re, Gs, Mm, Gg, Gs, Mm^Xm, Mm, Mm, Mm, Mm, Hh, Hh, Mm, Hh, Gg, Hh, Gs, Hh, Hh, Hh, Gs, Gs, Gs, Gs, Gd, Gs, Re, Hh, Gs, Hh, Hh, Mm, Mm^Xm, Mm, Ms, Ww
Mm, Hh, Hh, Mm, Hh, Gg, Gs, Re, Gg, Gg, Mm^Xm, Mm^Xm, Mm, Hh, Mm, Mm, Mm, Gg, Mm, Hh, Mm, Gs, Hh, Hh, Hh, Hh, Hh, Hh, Hh, Mm, Gs, Gs, Re, Re, Gs, Hh, Mm, Mm, Mm, Mm^Xm, Hh, Mm, Wo
Gg, Mm, Mm^Xm, Mm, Mm^Xm, Mm, Mm, Rb, Mm, Mm^Xm, Hh, Mm, Mm, Mm, Hh, Gg, Mm, Mm, Hh, Mm, Mm, Mm, Mm, Hh, Gs, Hh, Gs, Gs, Re, Gs, Re, Re, Re, Gs, Gs, Gs, Mm, Mm, Mm, Mm^Xm, Mm^Xm, Mm, Mm
Mm^Xm, Mm, Mm^Xm, Mm^Xm, Hh, Mm, Gg, Rb, Mm, Mm, Mm, Hh, Hh, Gg^Efm, Mm, Hh, Hh, Hh, Hh, Mm, Hh, Mm, Hh, Gg, Re, Re, Re, Re, Gs, Re, Ce, Ce, Ke, Hh, Hh, Hh, Mm, Mm, Mm, Mm, Mm^Xm, Mm, Mm
Mm^Xm, Mm^Xm, Mm, Mm, Mm, Mm, Mm, Rb, Mm, Mm, Gg, Hh, Mm, Gs, Mm, Hh, Mm, Hh, Re, Hh, Re, Re, Re, Re, Hh, Gs, Gg, Gs, Gs, Re, Mm, Ce, Hh, Gg, Hh, Gg, Mm, Mm, Mm, Mm^Xm, Hh, Hh^Fp, Mm
Mm, Mm, Mm, Mm, Mm, Mm, Mm, Re, Mm, Hh, Mm, Mm, Gs, Mm, Re, Hh^Vhh, Re, Re, Gs, Re, Hh, Gs, Gs, Gs, Gs, Gs, Hh, Hh, Re, Re, Hh, Mm, Mm, Hh, Gg, Hh, Hh, Mm, Mm, Mm^Xm, Hh, Hh^Fp, Gg^Efm
Gg, Hh, Hh, Hh, Mm, Hh, Gg, Re, Re, Mm, Re, Gs, Re, Re, Mm, Re, Gs, Hh, Gg, Gs, Gs, Gg, Gs, Gg, Gs, Gg, Hh, Re, Gs, Mm, Hh, Gg, Hh, Hh, Mm, Hh, Hh, Mm, Mm^Xm, Mm^Xm, Hh, Mm, Mm
Mm, Mm, Gg^Es, Hh, Mm, Mm, Hh, Re, Gg, Re, Mm, Re, Ke, Ce, Ce, Gs, Gg, Gs, Gs, Gs, Gg, Hh, Gs, Gs, Gs, Gs, Gs, Re, Mm, Hh^Vhh, Gg, Gs, Hh, Gg, Mm, Gg, Hh, Mm, Mm^Xm, Mm, Hh, Mm, Rb^Gvs
Mm, Mm, Hh, Mm, Gg, Hh, Gg, Rb, Re, Mm, Mm, Hh, Gg, Ce, Gs, Gg, Gs, Gg, Hh, Gg, Gs, Hh, Gs, Gg, Gs, Gs, Re, Re, Mm, Hh, Mm, Gg, Hh, Mm, Mm, Mm, Mm, Mm, Mm^Xm, Mm, Mm, Gg, Gg^Em
Hh, Mm, Mm, Mm, Hh, Hh, Hh, Gg, Re, Mm, Mm, Gg, Gg, Gs, Hh, Hh, Gg, Hh, Gg, Gg, Gg, Hh, Hh, Gg, Rb, Re, Mm, Mm, Hh, Hh, Gg, Gg, Mm, Gg, Mm, Mm, Mm, Mm, Mm^Xm, Mm, Mm, Gg, Gg^Efm
Hh, Mm, Mm, Mm, Gg, Hh, Hh, Gs, Gs, Re, Re, Mm, Gg, Gs, Gs, Gg, Hh, Gs, Gg, Hh, Gs, Gs, Gs, Gg, Re, Hh, Gs, Hh, Hh, Hh, Hh, Gg, Mm, Gg, Mm, Gg^Efm, Mm, Mm^Xm, Mm, Mm, Mm, Ss, Ss
Gg, Hh, Mm, Mm, Mm, Gg, Hh, Gs, Hh, Gg, Hh, Re, Rb, Hh, Mm, Hh, Gs, Hh, Hh, Gg, Gs, Gg, Hh, Rb, Hh, Gg, Hh, Gg, Hh, Mm, Hh, Gg, Mm, Mm, Mm, Mm, Ms, Ms^Xm, Mm^Xm, Mm, Mm, Gg, Ss
Gg^Efm, Hh, Mm, Hh, Gg, Mm, Mm, Gs, Gg, Hh, Hh, Gg, Gg, Rb, Rb, Gg, Gg, Gg^Efm, Hh, Gg, Gs, Gg, Rb, Rb, Hh, Gg^Es, Hh, Mm, Gg, Gg, Hh, Mm, Mm, Mm, Mm, Mm, Mm^Xm, Ms^Xm, Mm, Mm, Mm, Ss, Ss
Ww, Gg^Efm, Hh, Mm, Mm, Mm, Gg, Hh, Mm, Gg, Hh, Gg, Hh, Hh, Gg, Re, Re, Gg, Gg, Hh, Gs^Vh, Gg, Rb, Hh, Gg, Gg, Mm, Gg, Mm, Mm, Mm, Mm, Mm^Xm, Mm^Xm, Wo, Mm, Mm^Xm, Mm, Ww, Mm, Mm, Mm, Ww
Gg, Wo, Ww, Wo, Wo, Mm, Mm, Mm, Mm, Mm, Gg, Hh, Gg, Gg^Es, Hh, Hh, Gs, Rb, Re, Hh, Hh, Rb, Gg, Gg, Mm, Gg, Mm, Gg, Gg, Mm, Ms^Xm, Ms^Xm, Mm, Ww, Ww, Wo, Wo, Wo, Wo, Wo, Wo, Wo, Ww
Mm, Mm, Mm, Gg^Efm, Ms, Ww, Ww, Mm, Mm, Mm, Mm, Mm, Mm, Mm, Mm, Gg, Mm, Gg, Gs, Re, Rb, Rb, Hh, Hh, Hh, Mm, Mm^Xm, Mm^Xm, Ms^Xm, Hh, Rb, Mm, Gg^Emf, Wo, Mm, Ww, Ww, Wo, Wo, Wo, Ww, Ww, Gg
Mm, Mm, Mm, Mm, Mm, Ms, Ms, Ms, Hh, Mm, Mm, Mm, Mm, Mm, Mm, Mm, Mm, Mm, Mm, Gg, Re, Gg, Hh, Hh, Hh, Mm, Mm^Xm, Mm, Mm, Mm, Ww, Gs^Vc, Ww, Ww, Wo, Wo, Wo, Wo, Ww, Ww, Ww, Ss, Gg
Mm, Mm, Mm, Mm, Hh, Ms, Ms^Xm, Hh, Mm^Xm, Mm^Xm, Mm^Xm, Mm^Xm, Mm^Xm, Hh, Mm^Xm, Mm^Xm, Mm^Xm, Mm^Xm, Mm, Hh, Re, Gs, Mm, Mm, Mm, Mm, Wo, Ww, Ww, Ww, Wo, Ww, Wo, Wo, Ww, Wo, Wo, Ww, Gg, Ww, Gg, Gg, Ss
Mm^Xm, Mm, Mm, Hh, Mm^Xm, Ms^Xm, Wo, Mm^Xm, Mm, Mm, Mm, Mm, Mm, Mm^Xm, Mm, Mm, Mm, Mm, Hh, Hh, Rb, Gg, Mm, Mm, Mm, Mm, Wo, Ww, Wo, Wo, Wo, Wo, Wo, Wo, Wo, Wo, Ww, Wo, Gs^Vc, Gg, Gg, Gg, Gg
Mm, Mm^Xm, Mm^Xm, Mm^Xm, Mm, Mm, Mm, Mm, Mm, Mm, Mm, Mm, Mm, Mm, Mm, Mm, Mm, Mm, Mm, Gg, Re, Gs, Mm, Mm, Mm, Wo, Wo, Ww, Wo, Wo, Wo, Wo, Ww, Wo, Wo, Ww, Wo, Wo, Rb, Ss, Rb^Gvs, Ss, Gg
Mm, Mm, Mm, Mm, Mm, Mm, Hh, Mm, Mm, Mm, Mm, Gg, Hh, Hh^Fp, Wo, Mm, Mm, Mm, Mm, Gg, Rb, Gg, Gg, Mm, Mm, Mm, Ww, Wo, Wo, Wo, Ww, Wo, Ww, Wo, Ww, Ss, Rb, Rb, Rb, Ss, Gs^Vh, Rb^Gvs, Re
Hh, Mm, Hh, Hh, Mm, Hh, Mm, Hh, Hh, Mm, Hh, Mm, Mm, Mm^Xm, Mm^Xm, Mm^Xm, Mm, Mm, Mm, Hh^Vhh, Re, Gg, Mm, Mm, Mm, Mm, Ww, Wo, Wo, Ww, Ww, Ww, Gg, Ww, Rb, Rb, Gg, Ss, Gs, Rb, Rb, Rb, Gg
Hh, Mm, Mm, Hh, Mm, Mm, Gg, Hh, Mm, Hh, Gg, Mm, Mm^Xm, Mm^Xm, Mm, Hh, Mm, Mm, Rb, Rb, Mm, Mm, Mm, Mm, Mm, Mm, Wo, Wo, Ww, Ww, Gg^Efm, Gg, Gg, Gs^Vh, Rb^Gvs, Gg, Gg, Gg, Rb, Rb, Gg, Gg, Gg^Gvs
Hh, Mm, Mm, Mm, Hh^Fp, Mm, Mm, Hh, Mm, Mm, Hh, Mm, Mm, Mm, Hh, Hh, Mm, Gg, Re, Mm, Mm, Mm, Mm, Mm, Ww, Ww, Wo, Ww, Wo, Ww, Gg, Gg, Gg, Rb^Gvs, Rb^Gvs, Gg, Rp, Re, Gg, Gg, Gg, Ss, Gg
Mm, Hh^Fp, Hh^Fp, Hh^Fp, Mm, Gg^Efm, Hh, Mm, Mm^Xm, Mm^Xm, Mm, Mm, Gg, Mm, Hh, Mm, Hh, Hh, Re, Mm, Mm, Mm, Gg, Hh, Ww, Wo, Ww, Wo, Ww, Ww, Gg, Gg, Gg, Gg, Rp, Re, Gs, Gg, Gg, Gg, Gg, Ss, Gg
Gg, Gg, Hh, Hh^Fp, Gg, Mm, Mm, Mm, Mm, Mm, Hh^Fp, Hh, Mm, Mm, Hh, Mm, Gg^Es, Mm, Gg, Rb, Rb, Hh, Wo, Ww, Wo, Ww, Ww, Ww, Gg, Ss, Gg, Gg, Rp, Rp, Re, Gg, Gg, Gg, Rb^Gvs, Gg, Gg, Ss, Gg
Mm, Hh, Hh^Fp, Hh, Hh, Mm, Gg^Efm, Mm, Hh, Hh, Mm, Hh, Mm, Mm, Hh, Hh, Mm, Mm, Hh, Gg, Gg, Rb, Wo^Bw\, Ww, Chr, Wo, Ww, Ww, Ww, Gg, Rrc, Rrc, Gg, Gg, Gs, Re, Re, Rb, Rb^Gvs, Rb^Gvs, Rb, Gg, Ww
