border_size=1
usage=map

Hhd, Gd, Hhd, Gd, Mm^Xm, Mm, Mm, Gg, Gg, Gg, Gs, Re, Re, Gs, Hh, Mm, Hh, Hh, Mm^Xm, Mm, Mm, Hh, Gs, Mm, Mm, Gs, Re, Gs, Gs, Ww, Wo
Gd^Edpp, Hhd, Hhd, Md, Mm^Xm, Mm, Mm, Hh, Mm, Hh, Hh, Gg, Hh, Re, Hh, Mm, Hh, Mm, Mm, Mm^Xm, Hh, Gs, Gs, Gd, Hh, Hh, Gs, Gs, Gg, Gg^Vc, Gg
Hhd, Gd^Es, Hhd, Md, Mm^Xm, Mm^Xm, Mm^Xm, Mm, Mm^Xm, Mm, Mm, Gs, Hh, Rb, Rb, Mm, Mm, Hh, Gg, Mm^Xm, Mm^Xm, Gg, Mm^Xm, Gs, Gs, Rd, Gs, Gs, Gg, Gs, Gg
Gd^Es, Hhd, Md, Mm^Xm, Mm, Mm, Mm, Mm^Xm, Mm, Mm^Xm, Mm^Xm, Mm, Mm, Mm, Hh, Rb, Ch, Mm, Mm, Mm, Mm^Xm, Mm^Xm, Hh, Mm, Ch, Gs, Gg, Gs, Gg, Gg, Rb
Gd, Md, Mm^Xm, Mm^Xm, Hh^Fp, Mm, Mm, Mm, Mm, Mm, Mm, Mm^Xm, Mm^Xm, Mm, Ch, Re, Re, Hh, Hh, Hh, Mm, Hh, Gs, Hh, Gg, Gg, Ch, Gg, Rb, Rb, Gg
Md, Md, Mm^Xm, Mm, Hh, Hh, Hh, Mm, Gs, Mm, Mm, Mm, Mm, Mm^Xm, Hh, Gg, Gs, Rb, Rb, Gg, Gg, Gg, Gg, Gg, Gg, Gg, Rb, Rb, Ch, Gg^Vc, Ww
Md, Mm^Xm, Mm, Hh, Hh^Vhh, Hh, Hh, Mm, Mm, Mm, Hh, Hh, Hh, Mm^Xm, Hh, Gs, Gg, Gg, Gg, Rb, Rb, Gg, Ch, Gg, Rb, Rb, Wo, Ww, Wo, Wo, Wo
Mm^Xm, Mm^Xm, Mm, Mm, Hh, Gs, Gs, Hh, Gs, Hh, Gs, Gg, Hh, Mm^Xm, Ch, Gg, Rb, Rb, Rb, Re, Gs, Ch, Ch, Kh, Ww, Gg, Ww, Wo, Gg, Hh, Mm
Mm^Xm, Hh, Hh, Hh, Gs, Gs^Es, Gs, Gg, Gs, Gg, Gs, Gs, Re, Hh, Rb, Rb, Gg, Gg, Gg, Gg, Gg, Gg, Gg, Wo, Wo, Ww, Gg, Gg, Hh, Hh, Mm
Mm, Mm, Gs, Gg, Gs, Hh, Gg, Gg, Gs, Hh, Re, Re, Hh, Rb, Ch, Gs, Gg, Gg, Gg, Gg, Gg, Gg, Ww, Ww, Wo, Gg, Gg, Gg, Hh, Mm, Mm
Mm, Mm, Gg, Gg, Hh, Gs, Gs, Gs, Rb, Re, Gs, Hh, Mm, Hh, Mm^Xm, Gg, Gg, Gs, Ww, Ww, Wo, Ww, Ss, Ww, Wo, Ss, Hh, Hh, Mm, Mm, Mm
Gs, Gs, Gg, Gs, Gs, Gg, Gs, Gg, Re, Gg, Gg, Hh^Vhh, Mm^Xm, Mm^Xm, Mm, Hh, Mm, Ww, Gg, Gg, Ss, Sm, Ss, Ww, Ww, Gg^Efm, Hh, Mm, Mm, Mm, Mm
Mm, Gs^Es, Hh, Gs, Gs, Gg, Hh, Gs, Re, Gs, Hh, Mm^Xm, Mm, Mm^Xm, Ms^Xm, Mm, Ww, Ww, Hh, Ss, Ss, Gg^Efm, Ss, Gg^Efm, Ss, Ww, Ms, Mm, Ms^Xm, Mm^Xm, Mm^Xm
Hh, Mm, Gs, Gs, Gs, Gg, Gs, Gs, Rb, Gg, Hh, Mm^Xm, Mm, Mm, Ms^Xm, Ms^Xm, Mm^Xm, Ms, Hh, Ss, Hh, Gg, Hh, Hh, Hh, Ww, Mm^Xm, Ms^Xm, Mm, Mm^Xm, Mm
Hh^Fp, Gg, Gs, Gg, Gg, Gs, Gg, Rb, Gs, Gg, Gg, Mm, Mm, Mm, Mm, Ms^Xm, Mm^Xm, Ms, Mm, Gg, Hh, Hh, Mm, Mm, Mm^Xm, Mm^Xm, Mm, Mm, Mm, Mm, Mm
Mm, Hh, Hh, Gs, Gg^Es, Gs, Rb, Rb, Gs, Gg, Hh, Mm, Mm, Mm, Mm, Gg^Efm, Mm, Mm^Xm, Mm^Xm, Mm, Mm, Gg, Mm^Xm, Mm^Xm, Mm, Mm, Hh, Hh, Mm, Mm, Mm
Mm, Mm, Hh, Gg, Ce, Gs, Rb, Gs, Hh, Gs, Mm, Mm, Mm, Mm, Mm, Mm, Mm, Mm, Wo, Mm, Mm, Mm, Ms^Xm, Mm, Mm, Hh, Mm, Mm, Hh, Hh, Hh
Mm^Xm, Mm, Hh, Gg, Ke, Ce, Re, Gg, Mm, Hh^Vhh, Mm, Gg, Gg^Efm, Mm, Mm, Gg^Efm, Mm, Mm, Mm, Mm^Xm, Mm^Xm, Mm^Xm, Hh, Hh, Gd, Hh, Hhd, Hh, Hhd, Gd, Wwf
Mm, Mm, Mm, Hh, Hh, Ce, Re, Hh, Mm, Mm, Mm, Mm, Mm, Gg, Mm, Mm, Mm, Mm, Mm^Xm, Mm^Xm, Wo, Hh^Vhh, Gs, Gd, Hh, Hh, Gd, Hh, Hh, Gs, Re^Gvs
Mm, Hh, Mm, Hh, Gg, Hh, Re, Hh, Hh, Hh, Mm, Hh, Gg^Es, Mm, Mm, Mm, Hh, Gg^Efm, Ms^Xm, Ms^Xm, Mm, Mm, Hh, Gs, Gd, Gs, Gs, Gd, Gs, Mm, Gs
Mm, Hh, Mm, Hh, Hh, Re, Gg, Gs, Mm, Mm, Mm, Mm, Mm, Mm, Mm, Mm, Mm, Mm, Mm^Xm, Mm, Mm, Mm, Gs, Hh, Hhd, Hhd, Gs, Gd, Hh, Gs, Gs
Mm, Hh, Hh, Mm, Rb, Rb, Gg, Mm, Mm, Mm, Mm^Xm, Mm^Xm, Ms^Xm, Ms^Xm, Mm^Xm, Mm^Xm, Mm^Xm, Ms^Xm, Mm, Mm, Gs, Mm, Gs, Hh, Hh, Hh, Gd, Gs, Gd, Gs, Gd
Gg, Hh, Gg, Hh, Rb, Mm, Mm, Mm, Mm, Mm^Xm, Hh, Gg, Mm, Mm, Mm, Mm, Mm, Hh, Hh, Hh, Hh, Hh, Hh, Gs, Gs, Gs, Gs, Gs, Gd, Gs, Gs
Gg, Gg, Gg^Efm, Gg, Re, Gg, Mm, Mm, Gs, Mm^Xm, Mm, Mm, Mm, Mm, Hh, Mm, Mm, Hh, Gg, Hh, Gs, Hh, Hh, Gs, Gs, Hh, Gs, Gd, Gd, Gs, Re
Mm, Mm, Gg, Gg, Re, Gs, Gg, Gg, Mm^Xm, Mm^Xm, Hh, Mm, Mm, Mm, Gg, Hh, Hh, Hh, Gs, Hh, Hh, Hh, Hh, Hh, Hh, Gs, Mm, Gs, Gs, Gs, Re
Mm, Hh, Mm, Gs, Rb, Gg, Mm^Xm, Mm^Xm, Mm, Mm, Mm, Mm, Gg, Mm, Mm, Mm, Mm, Mm, Mm, Hh, Hh, Hh, Hh, Hh, Gs, Hh, Gs, Gs, Re, Re, Gs
Mm^Xm, Mm^Xm, Mm, Mm, Rb, Mm, Mm, Hh, Hh, Mm, Gg^Efm, Hh, Hh, Mm, Hh, Hh, Mm, Mm, Mm, Mm, Gg, Gs, Re, Gs, Re, Re, Re, Re, Ce, Re, Hh
