border_size=1
usage=map

Gll^Fp, Gll, Gll, Gg, Gs, Gs, Hh^Fp, Gg, Gg, Gg, Gs, Hh, Gg, Hh, Mm, Wo, Mm^Xm, Wo, Wo, Ms, Mm, Mm, Md, Mm, Md, Hhd, Md, Hh, Hhd, Hhd, Hhd, Rd, Gd, Hhd, Hhd, Hhd, Rd, Rd, Hhd, Hhd, Rd, Hhd, Dd^Edp, Dd, Hd, Dd, Hd, Dd, Dd^Dr
Gs, Gll^Fp, Gs, Gs^Fms, Gll, Gg, Gll^Fp, Hh^Fp, Gs, Gs^Fds, Gg, Hh, Hh, Hh, Mm, Mm, Mm^Xm, Mm, Ha, Ms, Mm, Md, Md, Md, Md, Hhd, Gd, Hhd, Gd, Hhd, Rd, Rd, Gd, Rd, Gd, Rd, Hhd, Hhd, Hhd, Hhd, Rd, Rd^Dr, Dd, Dd, Hd, Hd, Dd, Hd, Hd
Gll^Fp, Gll, Gs^Fms, Gs, Gs, Gll, Gs, Gs, Gg, Gg, Gg, Hh^Fms, Gg, Gg, Hh, Mm, Mm, Mm^Xm, Ha, Ha, Mm, Mm, Mm, Md, Mm, Gd, Md, Gd, Hhd, Hhd, Hhd, Gd, Hhd, Hhd, Hhd^Vhhr, Gd, Gd, Rd, Gd, Hhd, Dd, Hd, Hd, Dd, Hd, Dd, Dd, Dd, Dd^Dc
Gll^Fp, Gll^Fp, Gs, Gll^Fp, Gs, Gs^Fms, Gs, Gs^Fms, Gg, Gs^Fms, Gs, Gs^Fms, Gs, Gs^Fms, Gg, Hh, Hh^Fms, Mm, Mm, Mm^Xm, Mm, Mm, Mm, Hh, Gs, Md, Md, Md, Hhd, Hhd, Gd, Rd, Hhd, Hhd, Gd, Rd, Hhd, Rd, Rd, Rd, Rd, Hd, Rd, Hd, Dd, Hd, Dd, Dd, Hd
Gll^Fp, Gs^Fms, Gll, Gs, Gll^Fp, Gg, Gs, Gs, Gg, Gll^Fp, Gs^Fms, Gg, Hh, Gg, Gs^Fds, Hh, Gs, Hh, Hh, Mm, Mm, Mm, Mm, Mm, Md, Md, Hhd, Hhd, Hhd, Hhd, Gd, Gd, Gd, Hhd, Hhd, Rd, Gd, Gd, Hhd, Hhd, Rd, Hd, Dd^Edpp, Dd, Rd, Dd, Rd, Dd^Edp, Hhd
Gs, Gg, Gg, Gs^Vl, Gll^Fp, Gs, Gs^Fms, Gg, Gg, Gll^Fp, Gg, Hh^Fp, Gg, Gg, Hh, Gg, Hh^Fms, Gg, Mm, Mm, Mm, Hh, Mm, Hh, Md, Hhd, Md, Hhd, Gd, Gd, Gd, Gd, Gs, Rd, Hhd, Gd, Hhd, Hhd, Gd, Gd, Hhd, Rd, Hhd, Rd, Hd, Hd, Dd, Hd, Hd
Gs, Gs^Fms, Gll^Fp, Gll, Gs^Fms, Gg, Gs, Gll^Fp, Gs^Fms, Gg, Gs^Fms, Gs, Gg, Hh^Fp, Gg^Efm, Gg, Gg, Gs^Fms, Hh, Mm, Gg, Mm, Mm, Mm, Mm, Md, Md, Gs, Hhd, Hhd, Hhd, Gs, Gd, Gd, Hhd, Hhd, Hhd, Gd, Rd, Gd, Rd, Hhd, Rd, Dd, Rd^Esd, Hd, Hhd, Hhd, Md
Gg, Gll^Fp, Gs, Gs, Gs, Gs, Gs, Gs^Fms, Gg, Gs, Gg, Gg, Gs^Fms, Gg, Gg, Gs^Fms, Gs^Fds, Gg, Gs^Fds, Hh, Gs, Mm, Gg, Mm, Mm, Mm, Hh, Hhd, Gs, Hhd, Hhd, Gd, Gd, Gd, Gd, Gd, Rd, Rd, Rd, Rd, Hhd, Rd, Dd, Rd^Esd, Rd, Hhd, Md, Md, Hhd
Gs, Gs^Fms, Gll^Fp, Gg, Gs^Fms, Gs, Gs, Gs^Fds, Gs, Gs, Gs, Gg, Gs, Gg, Gs, Gs^Fms, Gg, Gs, Gg, Gg, Gg, Hh, Gg, Hh, Hh, Mm, Mm, Hhd, Hh, Gs, Gs, Gs, Gd, Hhd, Hhd, Hhd, Hhd, Rd, Gd, Rd, Hhd, Rd, Hhd, Hhd, Hhd, Dd, Hhd, Md, Mm^Xm
Gs, Gg, Gs, Gs, Gs, Gs, Gs^Fms, Gg, Gg, Gg, Gs^Vh, Gs^Fms, Gs, Gs, Gs^Fms, Gg, Gs^Fms, Gg, Hh^Fp, Hh, Hh^Vhh, Gg, Gg, Hh, Gg, Mm, Hh, Hh, Gs, Gs, Hh, Hhd, Hhd, Gd, Gd, Gd, Gd, Hhd, Hhd, Hhd, Md, Md, Md, Md, Hhd, Hhd, Mm, Mm^Xm, Mm^Xm
Gs, Gg, Gs^Fms, Gs, Gs, Gs^Fms, Gg, Gs^Fms, Gs^Fms, Gs^Fms, Gs^Fms, Gs^Fms, Gg, Gs^Fms, Gg, Gll^Fp, Gs^Fms, Gg, Gg, Gs, Gs, Gg, Gs^Fms, Gs, Gs, Gs, Gg, Gs, Hh, Hh, Hh, Md, Md, Hhd^Vhh, Mm^Xm, Hhd, Hhd, Gd, Mm^Xm, Hhd, Hh, Mm, Mm, Md, Mm^Xm, Md, Mm, Mm, Mm
Gs, Gs, Gg, Gg, Gs, Gg, Gs^Fms, Gs, Gs, Gg, Gll^Fp, Gll, Gs, Gs^Fms, Gs^Fms, Gs^Fms, Gs^Fds, Gs^Fms, Gg, Gg, Gg, Gs^Fms, Gs^Fms, Gs^Fms, Gg, Gs, Gg, Gs^Fms, Gg, Hh, Hh, Hh, Hh, Md, Md, Hhd, Md, Mm^Xm, Ms^Xm, Md, Hh, Mm, Mm^Xm, Mm^Xm, Mm, Mm, Mm, Mm, Hh
Gg, Gs, Gs^Fms, Gs^Fms, Gs^Fms, Gs, Gg, Gg, Gs^Fms, Gs, Gs, Gs, Gg, Gg, Gs, Gll^Fp, Gs^Fms, Gs^Fms, Gs^Fms, Gs, Gs, Gs^Fms, Gs, Gg, Gs^Fms, Gg, Gs^Fms, Gg, Gs^Fms, Gg, Gs, Gs, Gg, Hh, Hh, Md, Mm, Ms, Ms, Mm, Hh^Vhh, Mm, Hh, Mm, Hh, Mm, Hh, Hh, Gs
Gs^Fms, Gs^Fms, Gs^Vh, Gs^Fms, Gg, Gs, Gll^Fp, Gs^Fds, Gs^Fds, Gg, Gs^Fms, Gs^Fms, Gg, Gs^Fms, Gll^Fp, Gs^Fms, Gs, Gs^Vc, Gs^Fms, Gg, Gs^Fds, Gg, Gg, Gg, Gg, Gs^Fms, Gs^Fms, Gs^Fms, Gg, Gg^Vh, Gs^Fds, Gll^Fp, Gg, Hh, Gg, Gg, Hh, Ww, Mm, Mm, Gg, Hh, Gs, Gg, Hh, Mm, Mm, Gs, Hh
Gs, Gs^Fms, Gs, Gs^Fms, Gs, Gs^Fms, Gg, Gg^Efm, Gg, Gg, Gs^Fms, Gg, Gg, Gll^Fp, Gs^Fms, Gg^Efm, Gll^Fp, Gs^Fds, Gs^Fms, Gs^Fms, Gg, Gs^Fms, Gs^Fds, Gg, Gs^Fds, Gg, Gg, Gg, Gg, Gg, Gg, Gg, Gg, Gg, Gg, Gg, Wwf, Ww, Mm, Mm, Gg, Hh, Hh, Gs, Gs, Hh, Hh, Chr, Rr
Gs, Gs, Gg, Gs, Gs, Gs^Fms, Gs^Fms, Gs^Fds, Gs, Gs, Gg, Gs^Fms, Gs^Fms, Gs^Fds, Gs^Fms, Gs^Fms, Gg, Gs, Gg, Gg, Gg, Gg, Gs^Fds, Gg, Gg, Gg, Gs^Fds, Gs^Fms, Gg, Gg, Gs^Fds, Gg, Gg, Gg, Ww, Hh, Ww, Gg, Gg, Hh, Gg, Gg, Gs, Hh, Gs, Gs, Re, Rp, Chr
Gs, Gs^Fms, Gll^Fp, Gs, Gs, Gg, Gs, Gg, Gs, Gg, Gs^Fms, Gg, Gs^Fds, Gs, Gs, Gg, Gs^Fms, Gs^Fms, Gs^Fds, Gg, Gs^Fds, Gs^Fds, Gg, Gg, Gg, Gg, Gg, Gs^Fds, Gg, Gg, Ww, Gg, Ww, Wwf, Gg^Vc, Wo, Hh, Hh, Gg, Hh, Hh, Gs, Gg, Gg, Rp, Rp, Hh, Hh, Hh
Gs^Fms, Gs^Fms, Gll, Gg, Gg, Gg, Gg, Gs^Fms, Gg, Gg, Gs^Fds, Gg, Gg, Gg, Gs^Fms, Gg, Gg, Gs^Fms, Gg, Gs^Fds, Wo, Wo, Ww, Gs^Fms, Ww, Ww, Ww, Gg, Ww, Ww, Gs^Fds, Ww, Gg, Gg, Gs, Hh, Gg, Gg, Gg, Gg, Gg, Gs, Gg, Rr, Gs, Hh, Hh, Hh, Hh
Gs, Gs, Gs^Fms, Gs^Fms, Gll^Fp, Gs^Fms, Gg, Gs^Fds, Gg, Gs^Fds, Gg, Gg, Gs^Fds, Gg, Gs^Fms, Gg, Gs^Fms, Gg, Wo, Wo, Gg, Gg, Gg, Ww, Gs^Fds, Gg, Gg, Ww, Gg, Gg, Gg, Gg, Gg, Gg, Gs, Gs, Gs, Gs, Gg, Gg, Gg, Gg, Re, Rp, Gg, Hh, Hh, Hh, Gg
Gll^Fp, Gs, Gs^Fms, Gg, Gs^Fms, Gll^Fp, Gs^Fms, Gs, Gs^Fms, Gs^Fms, Gg, Gs^Fms, Gs^Fms, Gs^Fds, Gg, Gs^Fms, Gs^Fms, Gg, Wo, Gg^Efm, Gg, Gs^Fms, Gg, Gg^Vc, Gg, Gg, Rb, Gg, Rb, Gg, Gg, Gg, Gs, Gg, Gs, Gg, Gg, Gs, Gs, Gs, Gg, Gg, Rp, Gs, Hh, Gg, Gg, Hh, Hh
Gs, Gg, Gg, Gs, Gs^Fms, Gll^Fp, Gg, Gs, Gs, Gs^Fms, Gs^Fds, Gs^Fms, Gs, Gg, Gg^Vh, Gs^Fms, Gg, Gg, Wo, Gs^Fms, Gg, Gs, Gs, Gs^Fds, Rb, Rb, Gg, Rb, Gg, Rb, Rb, Gg, Gg, Gg, Gg, Gs, Gg, Gs, Gg, Gs, Gs, Gg, Rp, Hh, Hh, Gs, Hh, Hh, Gg
Gs, Gs^Fms, Gs, Gs, Gs^Fms, Gs^Fms, Gg, Gs^Fms, Gg, Gs^Fms, Gs, Gs^Fms, Gs, Gg, Gs^Fms, Gs^Fms, Wo, Ww, Ss, Gg, Gs, Gg, Rb, Rb, Gs, Gg, Gg, Gg, Gg, Gg, Gg, Rb, Rb, Gs, Gg, Gs, Gg, Gs, Gs, Gg, Gs, Gs^Vh, Rp, Gg, Gs, Hh, Gg, Gs, Gg
Gs^Fds, Gs^Fds, Gs, Gs^Fms, Gg, Gs, Gs^Fds, Gs^Fms, Gg, Gs^Fds, Gs^Fds, Gg, Gg, Gg, Gg, Wo, Gg, Gg, Gg, Gg, Rb, Rb, Gg, Gg, Gg, Gs, Gs, Gs, Gg, Gg, Gs, Gs, Rb, Gg, Gs, Gs, Gg, Gs, Gs, Gg, Gs, Rp, Gs, Gs, Gg, Gs, Gs, Hh, Gs
Gs^Fms, Gg, Gs, Gs, Gs^Fms, Gs, Gg, Gs, Gs, Gs^Fms, Gg, Gs^Fms, Gg, Gs^Fms, Gs, Wwf, Gs, Gs^Fms, Gg, Rb, Gg, Gg, Gs, Gg, Gg, Gg, Gg, Gg, Gg, Gg, Gg, Gg, Rb, Gg, Gg, Gg, Gg, Gg, Gs, Gs, Gg, Rp, Gg, Gg, Gs, Gs, Gg, Gg, Gg
Gs, Gg, Gs^Fms, Gg, Gs^Fms, Gll^Fp, Gs^Fms, Gs^Vl, Gs^Fms, Gs^Fms, Gs^Fms, Gg, Gg, Gs^Fms, Gs^Fds, Wo, Ww, Gg^Vc, Gg, Rb, Gg, Gg, Gg, Gg, Gs, Gg, Gs, Gg, Gg, Gs, Gg, Gg, Rb, Gs, Gg, Gg, Gs, Gg, Gs, Gg, Gg, Re, Gg, Gs, Gs, Gs, Gs, Gs, Gg
Gs^Fds, Gg, Gs, Gg, Gs^Fms, Gs^Fms, Gs, Gs^Fms, Gg, Gs, Gs, Gs, Gg, Gs^Fds, Gg, Gg, Wo, Gs^Fds, Gg, Rb, Gg, Gg, Gg, Gg, Gg, Gs, Gg, Gg, Rb, Gg, Rb, Gg, Rb, Gg, Gs, Gs, Gg, Gs, Gs, Gs, Rp, Rp, Gg, Gg, Gg, Gg, Gg, Gs, Rb^Eff
Gs^Fds, Gs, Gg, Gg, Gg, Gs, Gs, Gs^Fms, Gg, Gs^Fms, Gg, Gg, Gg, Gs^Fms, Gg, Gg, Wo, Gs^Fms, Gg, Rb, Rb, Gg, Rb, Gg, Rb, Gg, Rb, Rb, Gg, Rb, Gg, Rb, Gg, Gg, Gs, Gg, Gg, Gg, Gg, Gs, Re, Gs, Gg, Gg, Ww, Gg, Rb^Eff, Rb^Eff, Rb^Gvs
Gs, Gs, Gll^Fp, Gg, Gs^Fds, Gs^Fms, Gg, Gs, Gs^Fds, Gg, Gg, Gs^Fms, Gs^Fms, Gs^Fds, Wo, Wo, Gs^Fds, Gg, Gg, Gg, Gs, Rb, Gs, Rb, Gg, Rb, Gg, Gg, Gs, Gg, Gs, Gs, Gg, Gs, Gs, Gs, Gs, Gg, Re, Re, Gs, Gs^Vc, Gg, Ww, Rb^Eff, Rb^Eff, Rb^Gvs, Rb^Gvs, Rb^Gvs
Gg, Gll^Fp, Gs^Fms, Gs^Fms, Gg, Gg, Gs^Fms, Gs^Fms, Gs^Fms, Gg, Gs^Fms, Gs^Fds, Gg, Gg, Wo, Gs^Fds, Gg, Gs^Fds, Gg, Gs, Gs, Gg, Gg, Gs, Gs^Fds, Gg, Gg, Gs, Gg, Gg, Gg, Gg, Gg, Gg, Gg, Gg, Gg, Gg, Re, Gg, Gg, Gg, Rb^Eff, Rb^Eff, Rb^Gvs, Rb^Gvs, Rb^Gvs, Rb^Gvs, Rb^Gvs
