border_size=1
usage=map

Gd^Fdw, Hhd, Gd, Gd, Rd, Rd, Rd, Gd, Hhd, Gd^Vo, Gd, Gd, Gd^Es, Gd, Rd, Hhd, Md^Xm, Md^Xm, Md^Xm, Gd^Fdw, Rd, Rd, Rd, Rd, Gd, Md, Gd^Fdw, Md^Xm, Gd^Fdw, Rd, Gd, Md^Xm, Md^Xm, Md, Md, Hhd
Rd, Gd^Es, Gd, Gd, Rd, Rd, Gd, Gd^Fdw, Gd^Fdw, Gd^Fdw, Hhd, Gd, Gd, Rd, Rd, Gd, Gll, Gd^Fdw, Gd, Rd, Gd, Gd, Gd, Gll, Gd, Gd, Gd, Hhd, Rd, Rd, Hhd, Hhd, Hhd, Md^Xm, Md^Xm, Md
Rd, Rd, Rd, Rd, Gd^Fdw, Gd^Vo, Gd, Gd, Gd, Mm, Gd, Gd^Fdw, Gd, Rd, Co, Rd, Co, Gd, Rd, Rd, Gd^Fdw, Gd^Vo, Gd, Gd, Gd, Gd^Vo, Rd, Rd, Gd, Gd, Gd, Gd, Gd, Md, Md, Md^Xm
Md, Gd^Fdw, Rd, Rd, Gd^Efm, Hhd, Gd, Gd, Gd, Gd, Gd, Gd, Gd, Co, Ko, Ko, Rd, Rd, Rd, Md, Gd, Gd^Es, Gd, Gd^Dr, Gd^Fdw, Gd^Fdw, Gd^Fdw, Rd, Hhd, Gd^Fdw, Hhd, Gd, Hhd, Hhd, Mm, Mm
Hhd, Hhd, Rd, Gd^Fdw, Gd^Fdw, Gll, Hhd, Gd^Fdw, Gll, Gd^Es, Gd, Gd, Hhd, Co, Rd, Co, Rd, Rd, Gd, Gd, Gd, Gd, Gd, Gd^Fdw, Md^Xm, Hhd, Md, Hhd, Md, Md, Md, Md, Mm, Hhd, Mm^Xm, Mm
Hhd, Rd, Gd, Gd^Fdw, Gd^Fdw, Gd, Hhd, Md, Gd^Fdw, Gd^Fdw, Gd, Gd^Vo, Rd, Rd, Rd, Rd, Gd^Fdw, Hhd, Gd^Fdw, Gll, Gd^Fetd, Gd^Vo, Hhd, Md^Xm, Md, Md^Xm, Md, Hhd, Hh, Md, Mm, Mm, Mm, Mm, Mm^Xm, Mm^Xm
Rd, Rd, Gd, Gd, Gd, Md, Gd, Gd^Fdw, Gd^Fdw, Gll, Gd, Rd, Rd, Rd, Gd, Md, Gd, Gd^Fdw, Gll, Gd^Fdw, Gd, Hhd, Md, Md^Xm, Md, Md, Md, Mm^Xm, Hh, Md, Hh, Mm, Mm^Xm, Mm, Mm^Xm, Mm
Gd, Gd, Md, Hhd, Mm, Gd^Fdw, Md, Gd^Fdw, Hhd, Mm, Md, Rd, Md, Gd, Mm, Mm, Mm, Hhd, Md, Hhd, Md, Md, Md, Md, Md^Xm, Md, Mm, Hh, Re, Mm, Mm, Mm, Mm, Mm^Xm, Mm, Mm^Xm
Hhd, Hhd, Md, Md, Gs, Hhd, Md, Mm, Mm, Mm, Hh, Rd, Md, Mm, Mm^Xm, Mm, Md, Mm, Mm^Xm, Mm, Mm^Xm, Mm, Mm^Xm, Mm, Mm, Mm^Xm, Hh, Gg, Hh, Rb, Rb, Mm, Hh, Mm, Hh, Mm
Hhd, Md, Mm^Xm, Mm, Mm, Md, Mm^Xm, Mm^Xm, Mm, Mm, Hh, Re, Hh, Mm, Hh, Mm, Gg, Mm, Hh, Mm^Xm, Hh, Mm, Hh, Hh, Gg, Hh, Gg, Gg, Ss, Ss, Gg, Rb, Rb, Gg, Rb, Rb
Mm, Mm, Ms, Ms, Mm, Mm, Hh, Mm, Hh, Hh, Gs, Re, Gg, Gg, Gg, Hh, Gg, Hh, Gg, Gg, Gg, Gg, Gg, Gg, Gg, Gg, Gg, Ss, Ss, Gg, Ss, Gg, Gg, Rb, Gg, Ww
Md, Mm, Ms, Mm, Mm, Mm, Mm, Gs, Mm, Gs, Re, Rb, Gg, Gs, Gg, Gg, Ss, Gg, Gg, Hh, Ss, Sm, Ss, Gg, Gg, Ss, Ss, Ss, Ss, Ss, Ss, Gg, Wo, Ss, Ww, Ww
Md^Xm, Ms, Mm, Hh, Gs, Gs, Gg, Gg, Hh, Re, Gs, Gg, Gg, Gg, Gg, Ss, Ss, Ss, Ss, Gg, Ss, Gg, Ss, Ss, Ss, Ss, Gg, Ss, Ss, Ww, Wo, Wo, Ss, Ss, Ww, Ss
Md, Hh, Hh, Hh, Gs, Gs, Gs, Gs, Re, Re, Gg, Gg, Ss, Ss, Gg, Ss, Ss, Ww, Ss, Ss^Vhs, Gg, Ss, Ss^Vhs, Gg, Ss, Gg, Ss, Ss, Gg, Ss, Ww, Ss, Ss, Ww, Ww, Ww
Hh, Gs, Gs, Gs, Gg, Gg, Rb, Rb, Gg, Gg, Ss, Gg, Ss, Ss, Gg, Ww, Ss, Ww, Wwf, Ss, Gg, Gg, Gg, Ss, Ss, Gg, Ss, Ss, Ss, Ss, Wo, Wwf, Ww, Wo, Gg, Ss
Rb, Gs, Gs, Gs, Rb, Rb, Gg, Ss, Gg, Ss, Gg, Gg, Gg, Ww, Ss, Gg, Ss, Wo, Ss, Ss, Ss, Ss, Ss, Gg, Ss, Ss, Ss, Gg, Ss, Ss, Ss, Wo, Ww, Ss, Ww, Ss
Mm, Rb, Rb, Rb, Gg, Ss, Gg, Gg, Gg, Ss, Gg, Ss, Ss, Ss, Ss, Ss, Gg, Ww, Ww, Gg, Ss, Gg, Ss, Ss, Ss, Ww, Wo, Wo, Wo, Ww, Wo, Wo, Gg, Ww, Ww, Ww
Hh, Rb, Gg, Ss, Gg, Ss, Ww, Ss, Ss, Ss, Ss, Gg, Ss, Wwf, Ss, Ss^Vhs, Ss, Gg, Ss, Ww, Ss, Ss, Ss, Wwf, Ss, Ss, Sm, Ss, Ss^Vhs, Ss^Bw/r, Ss, Ss, Wwf, Ss, Wo, Wo
Wo, Wo, Wo, Ss, Ss, Gg, Ww, Ss, Ss, Ss^Vhs, Gg, Ss, Ss, Gg, Gg, Gg, Gg, Ss, Ss, Ww, Ss, Ww, Ww, Ss, Ss, Ss, Ss, Ss, Ss, Gg, Ss, Ss, Ss, Ss, Wo, Ss
Ss, Ss, Ss, Wo, Ss, Gg, Ss, Gg, Gg, Ww, Gg, Ss, Gg, Ss, Ww, Ss, Ww, Ww, Ss, Ss, Wo, Ww, Ss^Vhs, Gg, Gg, Ss, Ss, Gg, Sm, Gg, Gg, Ss, Ss, Ww, Ww, Ww
Gg, Gg, Ss, Ss, Ss, Ss, Gg, Ss, Ss, Ww, Ss, Gg, Ss, Ww, Ss, Ss, Gg, Ss, Ss, Ss, Wo, Ss, Gg, Ww, Ss, Ss, Ss, Ss, Ss, Ss, Ss, Wwf, Ww, Wo, Gg, Ss
Wo, Ss, Ww, Ss, Ss, Ss, Gg, Ss, Gg, Gg, Ww, Ss, Gg, Gg, Ss, Ss, Rb, Ss, Ss, Wo, Ss, Ss, Sm, Ss, Gg, Ss, Ss, Ss, Wwf, Ww, Ww, Ww, Wo, Hh, Gg, Ss
Mm, Wo, Ss, Wo, Ww, Ww, Wo, Ss, Gg, Ss, Gg, Ss, Rb, Ss, Wo, Ss, Ww, Rb, Ww, Ww, Ss, Gg, Rb, Ww, Ww, Ss, Wwf, Ss, Wo, Ww, Wo, Ss, Ss, Gg, Ss, Gg
Ss, Ss, Ss, Ww, Ss, Wo, Ss, Wo, Wwf, Ss, Ss, Rb, Ss, Ss, Ww, Ww, Ss, Wwf, Ss^Vhs, Ww, Ww, Wwf, Ww, Ss, Ww, Ww, Ss, Ww, Wo, Ww, Ww, Ss, Wwf, Ss, Ss, Ss
Wo, Ss, Ss, Ww, Ss, Gg^Efm, Sm, Ss, Ss, Wwf, Ww, Ss, Wwf, Ss^Vhs, Wo, Ww, Ss, Ss, Gg, Ss, Wwf, Ss, Gg^Efm, Wo, Ww, Ss, Ss^Vhs, Ww^Bw/r, Ww, Ww, Wo, Ww, Ss, Ww, Ss, Ss
Ss, Ww, Gg, Ww, Ss, Ss, Ss, Ss, Wo, Wo, Ww, Ww, Ss, Ww, Ww, Ss, Ss, Sm, Wo, Gg, Gg^Em, Ss, Gg, Wo, Wo, Gg, Gg, Gg, Ss, Ww, Ww, Ss, Ss, Sm, Gg, Ss
Md, Gg, Ss, Ss, Ss, Ss, Ww, Wwf, Ss, Ss, Sm, Ss, Gg, Ww, Ss, Ww, Ss, Ww, Ss, Ss, Gg, Ss, Ss, Ww, Ww, Ss, Ss, Ss, Ss, Ww, Ww, Gg, Ss, Ss, Hh, Ss
Md, Md, Mm, Ss, Ss, Ss, Ww, Gg, Ss, Ss, Ss, Gg, Ss, Ss, Ss, Ww, Wwf, Ss, Ss, Ss, Gg^Efm, Ss, Sm, Ww, Ss, Ww, Wwf, Ss, Ww, Ww, Wo, Ss, Ss, Hh, Mm, Hh
Md, Md, Mm, Hh, Ss, Wo, Hh, Ss, Ss, Gg, Hh, Gg, Ss, Ww, Ss, Ss, Ss, Ww, Ss, Ss, Ss, Ss, Ww, Wwf, Ss, Gg, Ss, Ww, Ss, Ss, Hh, Ww, Ss, Hh, Mm, Ms
Wog, Mm^Xm, Mm^Xm, Hh, Hh, Ww, Wo, Ss, Hh, Ss, Mm, Hh, Ss, Gg, Hh, Ss, Ss, Ww, Ww, Mm, Hh, Ss, Ww, Ss, Chs, Chs, Ss, Hh, Ss, Ss, Ss, Ww, Wo, Mm^Xm, Mm^Xm, Mm
Mm^Xm, Mm^Xm, Ms^Xm, Mm^Xm, Mm^Xm, Mm, Wo, Wo, Mm^Xm, Hh, Mm, Hh, Chs, Chs, Hh, Ss, Mm, Mm, Ms, Ms, Ww, Ww, Hh, Chs, Khs, Chs, Md, Hh, Hh, Ss, Hh, Ss, Mm^Xm, Ww, Ww, Ms
Mm^Xm, Ms^Xm, Ms^Xm, Ms^Xm, Mm^Xm, Mm^Xm, Ww, Mm, Mm^Xm, Mm, Gg^Efm, Mm, Khs, Chs, Mm, Mm, Ms, Ms, Ms, Ms, Ms^Xm, Hh, Md, Ss, Mm, Md, Mm^Xm, Gg, Mm^Xm, Mm, Mm^Xm, Mm^Xm, Mm, Hh, Hh, Ww
Md, Mm^Xm, Mm^Xm, Mm^Xm, Mm^Xm, Ww, Mm^Xm, Mm^Xm, Mm^Xm, Gg, Mm^Xm, Mm, Mm, Mm, Hh, Ms, Ms, Ms, Ms^Xm, Ms^Xm, Ms, Md, Md, Gg^Fet, Md, Md, Mm^Xm, Mm^Xm, Ms^Xm, Mm^Xm, Mm^Xm, Hh, Mm^Xm, Mm, Ms^Xm, Ms
Hh^Fp, Mm, Mm, Wo, Ms, Ms^Xm, Ms^Xm, Ms^Xm, Mm^Xm, Mm^Xm, Mm^Xm, Mm^Xm, Mm^Xm, Hh, Mm^Xm, Hh, Mm^Xm, Mm^Xm, Mm^Xm, Mm^Xm, Ms^Xm, Ms^Xm, Mm^Xm, Hh, Mm^Xm, Mm^Xm, Md, Mm^Xm, Mm^Xm, Ms^Xm, Ms^Xm, Hh, Ms^Xm, Ms^Xm, Ms^Xm, Ms^Xm
Hh^Fp, Mm, Ms^Xm, Mm, Mm^Xm, Mm^Xm, Md, Ms^Xm, Md, Mm, Mm, Ms^Xm, Ms^Xm, Ms^Xm, Ms^Xm, Ms^Xm, Ms^Xm, Ms^Xm, Ms^Xm, Ms^Xm, Mm^Xm, Ms^Xm, Mm^Xm, Mm^Xm, Md, Rb, Mm, Md, Mm^Xm, Mm^Xm, Md, Mm^Xm, Mm^Xm, Mm, Mm, Hh
Gg^Efm, Mm, Mm^Xm, Mm, Md, Ms, Mm, Ms, Hh, Mm, Md, Ms, Wo, Ms^Xm, Ms^Xm, Ms^Xm, Ms^Xm, Mm^Xm, Ms, Mm^Xm, Md, Mm^Xm, Md, Md, Md, Rb, Rb, Md, Mm^Xm, Md, Md, Hh, Hh, Hh, Gg, Hh
Gs^Fms, Gs^Fms, Gs^Fms, Gs^Fms, Mm, Hh, Hh, Hh, Gs^Fds, Hh, Md, Ms, Wo, Ms, Ms, Ms^Xm, Mm, Ms, Mm, Md, Hh^Fms, Mm^Xm, Hh, Hh, Mm, Md, Rb, Mm, Mm^Xm, Hh, Mm, Mm, Mm, Gg, Gg^Efm, Gg
