border_size=1
usage=map

Mm, Mm^Xm, Mm^Xm, Mm^Xm, Mm, Hh, Hh, Ke, Ce, Re, Hh, Mm, Mm, Mm, Mm, Gg^Efm, Gg, Mm, Mm, Mm, Mm, Mm, Mm^Xm, Mm^Xm, Hh^Vhh, Hh, Gd, Gd, Hh, Hhd, Hh, Hhd, Gs, Wwf, Gs^Vh, Gd, Gs, Gs, Rd, Re, Gs, Mm, Mm, Mm, Mm^Xm, Mm, Mm, Mm, Mm^Xm, Mm^Xm, Mm^Xm, Mm, Mm, Hh, Gg, Hh, Mm, Mm
Mm, Ms^Xm, Mm, Mm, Hh, Mm, Hh, Hh, Hh, Re, Hh, Mm, Hh, Mm, Hh, Mm, Mm, Mm, Mm, Mm, Gg^Efm, Mm^Xm, Ms^Xm, Wo, Mm, Gs, Gs, Hh, Gs, Gd, Gd, Hh, Mm, Re^Gvs, Gs, Gs, Re, Re, Hh, Gs, Gs, Hh, Mm, Mm, Mm^Xm, Ms, Mm, Mm, Mm^Xm, Wo, Wo, Mm^Xm, Mm, Hh, Mm^Xm, Mm, Mm^Xm, Mm^Xm
Mm^Xm, Ms^Xm, Mm, Mm, Hh, Mm, Hh, Gg, Re, Re, Gs, Hh, Mm, Mm, Mm, Gg^Es, Mm, Mm, Mm, Hh, Mm, Ms^Xm, Mm, Mm, Mm, Hh, Hh, Gd, Hhd, Gs, Gd, Gs, Gs, Gs, Gs, Gs, Re, Hhd, Mm, Gs, Gs, Hh, Ms, Ms, Mm^Xm, Ms^Xm, Ms^Xm, Ms^Xm, Mm, Mm^Xm, Mm^Xm, Mm^Xm, Mm^Xm, Mm^Xm, Mm^Xm, Mm^Xm, Mm^Xm, Mm^Xm
Mm^Xm, Mm, Hh, Mm, Hh, Mm, Mm, Hh, Rb, Gg, Mm, Mm, Mm, Mm, Mm^Xm, Mm, Ms^Xm, Mm, Mm^Xm, Mm, Ms^Xm, Mm^Xm, Mm, Mm, Mm, Gs, Hh, Hhd, Hh, Gs, Gs, Hh, Gs, Gs, Gs, Gs, Re, Gs, Gs, Hh, Mm, Mm, Mm^Xm, Mm^Xm, Ms, Ms, Hh, Mm, Hh^Fms, Mm, Hh, Mm, Ms^Xm, Mm, Mm^Xm, Mm, Ms^Xm, Ms^Xm
Mm, Hh, Hh^Vhh, Mm, Hh, Hh, Hh, Rb, Mm, Gg, Mm, Mm, Mm^Xm, Mm^Xm, Gg, Ms^Xm, Mm, Mm^Xm, Mm, Mm^Xm, Hh, Mm, Hh, Gs, Hh, Gs, Gs, Hh, Gs, Gd, Gs, Gd, Gs, Gd, Gs, Re, Hh, Hh, Gd^Vhr, Mm, Mm, Mm^Xm, Ms, Ms, Ms, Ms, Mm^Xm, Mm, Hh^Fms, Gs^Es, Gs, Mm^Xm, Mm^Xm, Mm^Xm, Ww, Ww, Mm, Mm
Gg, Hh, Gg^Efm, Gg, Gg, Gg, Gg, Rb, Gg, Mm, Mm, Mm, Mm^Xm, Hh, Mm, Mm, Mm, Mm, Mm, Mm, Hh, Hh, Hh, Hh, Hh, Hh, Gs, Gs, Hh, Gs, Gd, Gd, Gs, Gs, Re, Re, Gd, Rd, Hh, Mm, Mm^Xm, Mm^Xm, Ms, Ww, Hh, Hh, Gg, Hh, Hh, Hh, Gg, Hh, Mm, Hh, Ww, Ms^Xm, Ms^Xm, Mm
Hh, Hh, Gg, Gg, Mm, Gg^Efm, Gg, Re, Gs, Mm, Gg, Gs, Mm^Xm, Mm, Mm, Mm, Mm, Hh, Hh, Mm, Hh, Gg, Hh, Gs, Hh, Hh, Hh, Gs, Gs, Gs, Gs, Gd, Gs, Re, Hh, Gs, Hh, Hh, Mm, Mm^Xm, Mm, Ms, Ww, Wo, Mm, Gg, Gs, Hh, Mm, Hh, Gg, Hh, Ss, Ww, Gg, Mm, Hh, Mm
Mm, Hh, Hh, Mm, Hh, Gg, Gs, Re, Gg, Gg, Mm^Xm, Mm^Xm, Mm, Hh, Mm, Mm, Mm, Gg, Mm, Hh, Mm, Gs, Hh, Hh, Hh, Hh, Hh, Hh, Hh, Mm, Gs, Gs, Re, Re, Gs, Hh, Mm, Mm, Mm, Mm^Xm, Hh, Mm, Wo, Hh, Mm, Mm, Gg, Hh, Hh, Ss, Wwf, Gg, Ww, Ww, Rb, Rb, Rb, Rb
Gg, Mm, Mm^Xm, Mm, Mm^Xm, Mm, Mm, Rb, Mm, Mm^Xm, Hh, Mm, Mm, Mm, Hh, Gg, Mm, Mm, Hh, Mm, Mm, Mm, Mm, Hh, Gs, Hh, Gs, Gs, Re, Gs, Re, Re, Re, Gs, Gs, Gs, Mm, Mm, Mm, Mm^Xm, Mm^Xm, Mm, Mm, Wo, Ww, Gg^Efm, Gg, Gg, Ww, Ww, Gg, Wo, Sm, Sm, Ss, Hh, Hh, Mm
Mm^Xm, Mm, Mm^Xm, Mm^Xm, Hh, Mm, Gg, Rb, Mm, Mm, Mm, Hh, Hh, Gg^Efm, Mm, Hh, Hh, Hh, Hh, Mm, Hh, Mm, Hh, Gg, Re, Re, Re, Re, Gs, Re, Ce, Ce, Ke, Hh, Hh, Hh, Mm, Mm, Mm, Mm, Mm^Xm, Mm, Mm, Hh, Hh, Wwf, Ww, Ss, Ww, Gg, Rb, Rb, Ss, Ss, Ss, Gg, Ss, Ss
Mm^Xm, Mm^Xm, Mm, Mm, Mm, Mm, Mm, Rb, Mm, Mm, Gg, Hh, Mm, Gs, Mm, Hh, Mm, Hh, Re, Hh, Re, Re, Re, Re, Hh, Gs, Gg, Gs, Gs, Re, Mm, Ce, Hh, Gg, Hh, Gg, Mm, Mm, Mm, Mm^Xm, Hh, Hh^Fp, Mm, Mm, Gg, Gg, Ww, Gg, Ww, Gg^Vc, Rb, Ss, Ss, Gg, Gg^Efm, Ss, Gg, Ss
Mm, Mm, Mm, Mm, Mm, Mm, Mm, Re, Mm, Hh, Mm, Mm, Gs, Mm, Re, Hh^Vhh, Re, Re, Gs, Re, Hh, Gs, Gs, Gs, Gs, Gs, Hh, Hh, Re, Re, Hh, Mm, Mm, Hh, Gg, Hh, Hh, Mm, Mm, Mm^Xm, Hh, Hh^Fp, Gg^Efm, Gg^Es, Mm, Hh, Wo, Wo, Sm, Gg, Rb, Gg, Gg, Ss, Ss, Gg, Ww, Ww
Gg, Hh, Hh, Hh, Mm, Hh, Gg, Re, Re, Mm, Re, Gs, Re, Re, Mm, Re, Gs, Hh, Gg, Gs, Gs, Gg, Gs, Gg, Gs, Gg, Hh, Re, Gs, Mm, Hh, Gg, Hh, Hh, Mm, Hh, Hh, Mm, Mm^Xm, Mm^Xm, Hh, Mm, Mm, Mm, Mm, Gg, Ww, Ss, Sm, Ss, Rb, Ss, Gg^Em, Ss, Ss, Gg, Ww, Ww
Mm, Mm, Gg^Es, Hh, Mm, Mm, Hh, Re, Gg, Re, Mm, Re, Ke, Ce, Ce, Gs, Gg, Gs, Gs, Gs, Gg, Hh, Gs, Gs, Gs, Gs, Gs, Re, Mm, Hh^Vhh, Gg, Gs, Hh, Gg, Mm, Gg, Hh, Mm, Mm^Xm, Mm, Hh, Mm, Rb^Gvs, Rb^Gvs, Gg^Vc, Ww, Wo, Ss, Gg, Ss, Rb, Ss, Ss, Sm, Gg, Ww, Ww, Gg
Mm, Mm, Hh, Mm, Gg, Hh, Gg, Rb, Re, Mm, Mm, Hh, Gg, Ce, Gs, Gg, Gs, Gg, Hh, Gg, Gs, Hh, Gs, Gg, Gs, Gs, Re, Re, Mm, Hh, Mm, Gg, Hh, Mm, Mm, Mm, Mm, Mm, Mm^Xm, Mm, Mm, Gg, Gg^Em, Rb^Gvs, Rb, Wo, Wo, Gg, Ww, Rb, Gg, Gg^Vc, Gg, Hh, Ww, Ww, Sm, Ss
Hh, Mm, Mm, Mm, Hh, Hh, Hh, Gg, Re, Mm, Mm, Gg, Gg, Gs, Hh, Hh, Gg, Hh, Gg, Gg, Gg, Hh, Hh, Gg, Rb, Re, Mm, Mm, Hh, Hh, Gg, Gg, Mm, Gg, Mm, Mm, Mm, Mm, Mm^Xm, Mm, Mm, Gg, Gg^Efm, Rb, Ss, Ww, Ww, Wo, Ww, Ww^Bw|r, Ww, Ww, Wo, Wwf, Gg, Ww, Hh, Gg
Hh, Mm, Mm, Mm, Gg, Hh, Hh, Gs, Gs, Re, Re, Mm, Gg, Gs, Gs, Gg, Hh, Gs, Gg, Hh, Gs, Gs, Gs, Gg, Re, Hh, Gs, Hh, Hh, Hh, Hh, Gg, Mm, Gg, Mm, Gg^Efm, Mm, Mm^Xm, Mm, Mm, Mm, Ss, Ss, Rb, Wwf, Ww, Wo, Wo, Ss, Wwf, Ww, Ww, Ww, Md, Gg, Md, Md, Md
Gg, Hh, Mm, Mm, Mm, Gg, Hh, Gs, Hh, Gg, Hh, Re, Rb, Hh, Mm, Hh, Gs, Hh, Hh, Gg, Gs, Gg, Hh, Rb, Hh, Gg, Hh, Gg, Hh, Mm, Hh, Gg, Mm, Mm, Mm, Mm, Ms, Ms^Xm, Mm^Xm, Mm, Mm, Gg, Ss, Ww, Ss, Gg, Wo, Ss, Gg, Ww^Bw|r, Ww, Gg, Ww, Ww, Gg, Hh, Rb, Gg
Gg^Efm, Hh, Mm, Hh, Gg, Mm, Mm, Gs, Gg, Hh, Hh, Gg, Gg, Rb, Rb, Gg, Gg, Gg^Efm, Hh, Gg, Gs, Gg, Rb, Rb, Hh, Gg^Es, Hh, Mm, Gg, Gg, Hh, Mm, Mm, Mm, Mm, Mm, Mm^Xm, Ms^Xm, Mm, Mm, Mm, Ss, Ss, Ww, Wo, Wo^Bw|r, Ww, Gg, Gg, Rb, Ss, Ww, Ww, Ww, Rb, Rb, Ss, Re
Ww, Gg^Efm, Hh, Mm, Mm, Mm, Gg, Hh, Mm, Gg, Hh, Gg, Hh, Hh, Gg, Re, Re, Gg, Gg, Hh, Gg^Vh, Gg, Rb, Hh, Gg, Gg, Mm, Gg, Mm, Mm, Mm, Mm, Mm^Xm, Mm^Xm, Wo, Mm, Mm^Xm, Mm, Ww, Mm, Mm, Mm, Ww, Ww, Wo, Wwf, Gg, Ss, Gg, Rb, Chs, Ww, Wwf, Ww^Bw/r, Wwf, Gg, Ss, Gg
Gg, Wo, Ww, Wo, Wo, Mm, Mm, Mm, Mm, Mm, Gg, Hh, Gg, Gg^Es, Hh, Hh, Gs, Rb, Re, Hh, Hh, Rb, Gg, Gg, Mm, Gg, Mm, Gg, Gg, Mm, Ms^Xm, Ms^Xm, Mm, Ww, Ww, Wo, Wo, Wo, Wo, Wo, Wo, Wo, Ww, Wo, Ww, Ss, Gg, Ss, Ss, Rb, Rb, Rb, Gg, Ww, Ww, Ww, Ww, Gg
Mm, Mm, Mm, Gg^Efm, Ms, Ww, Ww, Mm, Mm, Mm, Mm, Mm, Mm, Mm, Mm, Gg, Mm, Gg, Gs, Re, Rb, Rb, Hh, Hh, Hh, Mm, Mm^Xm, Mm^Xm, Ms^Xm, Hh, Rb, Mm, Gg^Emf, Wo, Mm, Ww, Ww, Wo, Wo, Wo, Ww, Ww, Gg, Gg, Ss^Vhs, Gg, Gg, Gg, Rb, Rb, Gg, Gg, Gg, Gg, Ww, Ww, Ww, Gg
Mm, Mm, Mm, Mm, Mm, Ms, Ms, Ms, Hh, Mm, Mm, Mm, Mm, Mm, Mm, Mm, Mm, Mm, Mm, Gg, Re, Gg, Hh, Hh, Hh, Mm, Mm^Xm, Mm, Mm, Mm, Ww, Gg^Vc, Ww, Ww, Wo, Wo, Wo, Wo, Ww, Ww, Ww, Ss, Gg, Ss, Ss, Sm, Gg, Re, Re, Gg, Ss, Gg, Ss, Gg^Vc, Ww, Ww, Gg, Ww
Mm, Mm, Mm, Mm, Hh, Ms, Ms^Xm, Hh, Mm^Xm, Mm^Xm, Mm^Xm, Mm^Xm, Mm^Xm, Hh, Mm^Xm, Mm^Xm, Mm^Xm, Mm^Xm, Mm, Hh, Re, Gs, Mm, Mm, Mm, Mm, Wo, Ww, Ww, Ww, Wo, Ww, Wo, Wo, Ww, Wo, Wo, Ww, Gg, Ww, Gg, Gg, Ss, Gg^Efm, Ss, Ss, Gg, Rb, Gg, Gg, Gg, Gg, Gg, Gg, Gg, Ww, Ss, Gg
Mm^Xm, Mm, Mm, Hh, Mm^Xm, Ms^Xm, Wo, Mm^Xm, Mm, Mm, Mm, Mm, Mm, Mm^Xm, Mm, Mm, Mm, Mm, Hh, Hh, Rb, Gg, Mm, Mm, Mm, Mm, Wo, Ww, Wo, Wo, Wo, Wo, Wo, Wo, Wo, Wo, Ww, Wo, Gg^Vc, Gg, Gg, Gg, Gg, Gg, Gg, Ss, Rb, Rb, Ss, Ss, Wo, Wo, Ww, Ss, Gg, Ww, Ww, Ww
Mm, Mm^Xm, Mm^Xm, Mm^Xm, Mm, Mm, Mm, Mm, Mm, Mm, Mm, Mm, Mm, Mm, Mm, Mm, Mm, Mm, Mm, Gg, Re, Gs, Mm, Mm, Mm, Wo, Wo, Ww, Wo, Wo, Wo, Wo, Ww, Wo, Wo, Ww, Wo, Wo, Rb, Ss, Rb^Gvs, Ss, Gg, Ss, Rb, Rb, Gg^Vc, Gg, Gg^Em, Ss, Ss, Ww, Ss, Rb, Gg, Ww, Ww, Ww
Mm, Mm, Mm, Mm, Mm, Mm, Hh, Mm, Mm, Mm, Mm, Gg, Hh, Hh^Fp, Wo, Mm, Mm, Mm, Mm, Gg, Rb, Gg, Gg, Mm, Mm, Mm, Ww, Wo, Wo, Wo, Ww, Wo, Ww, Wo, Ww, Ss, Rb, Rb, Rb, Ss, Gg^Vh, Rb^Gvs, Re, Rb, Gg, Ss, Ss, Ss, Ss, Ss, Ww, Ww, Wo, Gg^Vc, Wo, Ww, Ww, Hh
Hh, Mm, Hh, Hh, Mm, Hh, Mm, Hh, Hh, Mm, Hh, Mm, Mm, Mm^Xm, Mm^Xm, Mm^Xm, Mm, Mm, Mm, Hh^Vhh, Re, Gg, Mm, Mm, Mm, Mm, Ww, Wo, Wo, Ww, Ww, Ww, Gg, Ww, Rb, Rb, Gg, Ss, Gs, Rb, Rb, Rb, Gg, Gg, Ss, Ss, Ww, Ss, Ss, Gg, Ss, Ss, Ss, Ww, Wo, Wo, Ww, Ww
Hh, Mm, Mm, Hh, Mm, Mm, Gg, Hh, Mm, Hh, Gg, Mm, Mm^Xm, Mm^Xm, Mm, Hh, Mm, Mm, Rb, Rb, Mm, Mm, Mm, Mm, Mm, Mm, Wo, Wo, Ww, Ww, Gg^Efm, Gg, Gg, Gg^Vh, Rb^Gvs, Gg, Gg, Gg, Rb, Rb, Gg, Gg, Gg^Gvs, Gg^Gvs, Ss, Gg, Gg, Wo, Wo, Ss, Ss, Gg, Wo, Ww, Ss, Ss, Ww, Ss
Hh, Mm, Mm, Mm, Hh^Fp, Mm, Mm, Hh, Mm, Mm, Hh, Mm, Mm, Mm, Hh, Hh, Mm, Gg, Re, Mm, Mm, Mm, Mm, Mm, Ww, Ww, Wo, Ww, Wo, Ww, Gg, Gg, Gg, Rb^Gvs, Rb^Gvs, Gg, Rp, Re, Gg, Gg, Gg, Ss, Gg, Gg^Gvs, Ss, Ss, Ss, Ss, Gg, Ss, Ss, Ww, Wo, Gg, Gg, Ww^Ewf, Ww, Gg
Mm, Hh^Fp, Hh^Fp, Hh^Fp, Mm, Gg^Efm, Hh, Mm, Mm^Xm, Mm^Xm, Mm, Mm, Gg, Mm, Hh, Mm, Hh, Hh, Re, Mm, Mm, Mm, Gg, Hh, Ww, Wo, Ww, Wo, Ww, Ww, Gg, Gg, Gg, Gg, Rp, Re, Gs, Gg, Gg, Gg, Gg, Ss, Gg, Ss, Ss, Wo, Ss, Ww, Mm, Gg^Efm, Gg, Gg, Ww, Wo, Gg^Vc, Ss, Gg^Em, Gg^Efm
Gg, Gg, Hh, Hh^Fp, Gg, Mm, Mm, Mm, Mm, Mm, Hh^Fp, Hh, Mm, Mm, Hh, Mm, Gg^Es, Mm, Gg, Rb, Rb, Hh, Wo, Ww, Wo, Ww, Ww, Ww, Gg, Ss, Gg, Gg, Rp, Rp, Re, Gg, Gg, Gg, Rb^Gvs, Gg, Gg, Ss, Gg, Ss^Vhs, Ww, Ww, Ww, Ss, Ss, Ss, Wo, Wo, Hh, Ww, Ww, Ss, Ww, Wo
Mm, Hh, Hh^Fp, Hh, Hh, Mm, Gg^Efm, Mm, Hh, Hh, Mm, Hh, Mm, Mm, Hh, Hh, Mm, Mm, Hh, Gg, Gg, Rb, Wo^Bw\, Ww, Chr, Wo, Ww, Ww, Ww, Gg, Rrc, Rrc, Gg, Gg, Gs, Re, Re, Rb, Rb^Gvs, Rb^Gvs, Rb, Gg, Ww, Ww, Ss, Gg, Gg, Ww, Wo, Ww, Mm, Mm, Ss, Ss, Wo, Wo, Ss, Gg
Hh, Hh^Fp, Mm, Mm, Hh^Fp, Mm, Mm, Mm, Hh, Gg, Mm, Hh, Hh, Mm, Mm, Mm, Mm, Mm, Hh, Hh, Wo, Wo, Ch, Rrc, Rrc, Hh, Rrc, Gg, Rrc, Rrc, Hh, Gg, Gg, Gg, Gs, Gs, Gg, Re, Gg^Vh, Rb^Gvs, Rb, Ss, Ww, Ss, Ss, Gg, Rb^Gvs, Rb^Gvs, Rb^Gvs, Gg, Mm, Hh, Gg, Hh, Ww, Ww, Wo, Ss
Hh^Fp, Mm, Mm, Hh, Mm, Mm, Mm, Mm, Mm, Hh, Mm, Hh, Gg, Mm, Mm, Mm, Wo, Gg, Ww, Ww, Gg, Gg, Gg, Gg, Rrc, Rrc, Rrc, Rrc, Rrc, Ch, Gg, Gg, Hh, Gg, Gg, Gg, Gg, Gg, Gg, Rb^Gvs, Ww, Ww, Wo, Ww, Ww, Gg, Hh, Rb^Gvs, Gg^Vc, Rb, Re, Mm, Mm, Hh, Ss^Vhs, Ww, Ss, Ww
Hh, Hh^Fp, Hh, Mm, Gg, Mm, Hh, Gg^Emf, Mm, Hh, Hh, Hh^Fp, Ww, Hh, Ww, Wo, Ww, Ww, Ww, Gg, Gg, Gg, Rrc, Rrc, Rrc, Rrc, Ch, Rrc, Rrc, Rrc, Rrc, Hh, Ch, Gs, Gs, Gg, Gg, Gg, Gg, Rb^Gvs, Ww, Ww, Wo, Ww, Ww, Gg, Gg, Hh, Mm, Mm, Gg, Re, Rb, Rb, Hh, Ww, Gg, Ss
Hh^Fp, Mm, Gg, Mm, Mm, Mm, Mm, Mm, Wo, Ss, Ww, Ww, Ww, Ww, Ww, Ww, Gg, Ww, Ss, Gg, Rrc, Rrc, Rrc, Rrc, Hh, Ch, Kh, Ch, Gg, Rrc, Rrc, Rrc, Rrc, Gg, Ch, Gs, Gs, Gs, Gg, Rb, Gg, Ss, Wwf, Gg, Rb^Gvs, Rb^Gvs, Gg^Vc, Hh, Gg^Efm, Hh, Hh, Mm, Gg, Mm, Hh, Hh, Gg^Em, Ss
Ww, Ww, Ww, Gg, Hh, Wo, Ww, Hh, Ww, Ww, Ww, Ww, Mm, Mm, Hh, Mm, Hh, Gg, Rrc, Rrc, Rrc, Rrc, Ch, Hh, Hh, Ch, Hh, Hh, Hh, Gs, Hh, Rrc, Rrc, Rrc, Rrc, Gg, Gg, Gg, Gg, Ss, Ww, Gg, Wwf, Gg, Rb^Gvs, Rb^Gvs, Hh, Mm, Hh, Hh, Hh, Mm, Mm, Mm, Mm, Hh, Hh, Ss
Ww, Ww, Ww, Ww, Wo, Wo, Ww, Ww, Ww, Ww, Hh, Gg, Hh, Gg, Rrc, Mm, Rrc, Ch, Rrc, Rrc, Gs, Gg, Hh, Hh, Mm, Hh, Mm, Mm, Mm, Hh, Gs, Hh, Ch, Rrc, Rrc, Rrc, Rrc, Ch, Hh, Ww, Wo, Ww, Gg, Gg, Gg, Gg, Hh, Mm, Hh, Mm, Mm, Gg, Hh, Mm, Mm, Mm, Mm, Mm
Ww, Ww, Ww, Ww, Hh, Mm, Mm, Hh, Rrc, Hh, Rrc, Rrc, Rrc, Rrc, Rrc, Rrc, Rrc, Rrc, Rrc, Rrc, Ch, Gg, Gg, Gg, Hh, Hh, Mm, Hh, Mm, Hh, Gg, Gg, Hh, Gs, Gs, Rrc, Rrc, Rrc, Ch, Wo, Wo, Gg, Mm, Gg, Gs, Gg, Rb^Gvs, Rb^Gvs, Gg, Hh, Gg, Mm, Hh, Mm, Mm, Mm, Mm, Mm
Gg, Mm, Hh, Gg, Rrc, Rrc, Rrc, Rrc, Rrc, Rrc, Rrc, Rrc, Rrc, Rrc, Rb^Gvs, Rrc, Rb^Gvs, Rrc, Re, Hh, Mm, Hh, Rb^Gvs, Hh, Gg, Mm, Hh, Hh, Hh, Mm, Mm, Hh, Gg, Gs, Gs, Ch, Rrc, Rrc, Rrc, Wo, Gg^Fet, Mm, Gg, Gg, Gg, Gg, Rb^Gvs, Rb^Gvs, Gg, Gg, Hh, Mm, Hh, Mm, Mm, Gg, Mm, Mm
Rrc, Hh, Rrc, Rrc, Rrc, Rrc, Rrc, Rrc, Rb^Gvs, Rrc, Rb^Gvs, Rb^Gvs, Rb^Gvs, Rb^Gvs, Rb^Gvs, Rb^Gvs, Rb^Gvs, Ch, Rb^Gvs, Re, Rb^Gvs, Rb^Gvs, Rb^Gvs, Gg, Rb^Gvs, Hh, Rb^Gvs, Rb^Gvs, Rb^Gvs, Gg^Vl, Rb^Gvs, Gg, Rb^Gvs, Gg, Rb^Gvs, Gg, Rrc, Rrc, Rrc, Wo, Rb^Gvs, Rb^Gvs, Rb^Gvs, Gg, Rb^Gvs, Gg^Vh, Rb^Gvs, Rb^Gvs, Rb^Gvs, Hh, Rb^Gvs, Hh, Mm, Mm, Mm, Mm, Mm, Mm
Rrc, Rrc, Rrc, Rrc, Rb^Gvs, Hh, Rb^Gvs, Rb^Gvs, Rb^Gvs, Rb^Gvs, Rb^Gvs, Rb^Gvs, Rb^Gvs, Rb^Gvs, Rb^Gvs, Rb^Gvs, Rb^Gvs, Rb^Gvs, Rb^Gvs, Re, Re, Rb^Gvs, Gg^Vh, Rb^Gvs, Rb^Gvs, Rb^Gvs, Rb^Gvs, Rb^Gvs, Rb^Gvs, Rb^Gvs, Rb^Gvs, Rb^Gvs, Rb^Gvs, Rb^Gvs, Rb^Gvs, Rb^Gvs, Rb^Gvs, Rrc, Rrc, Qxu^Bsb\, Rrc, Rb^Gvs, Rb^Gvs, Rb^Gvs, Rb^Gvs, Rb^Gvs, Rb^Gvs, Rb^Gvs, Rb^Gvs, Rb^Gvs, Hh, Gg, Mm, Mm, Mm, Mm, Mm, Mm
Mm, Rrc, Gg, Mm, Mm, Rb^Gvs, Rb^Gvs, Rb^Gvs, Rb^Gvs, Gg^Vl, Rb^Gvs, Hh, Rb^Gvs, Rb^Gvs, Rb^Gvs, Rb^Gvs, Gg^Vh, Rb^Gvs, Rb^Gvs, Rb^Gvs, Re, Gg^Vl, Rb^Gvs, Rb^Gvs, Rb^Gvs, Rb^Gvs, Rb^Gvs, Rb^Gvs, Rb^Gvs, Rb^Gvs, Rb^Gvs, Rb^Gvs, Rb^Gvs, Rb^Gvs, Rb^Gvs, Rb^Gvs, Rb^Gvs, Rb^Gvs, Wo, Qxu^Bsb\, Rrc, Rrc, Rrc, Rb^Gvs, Gg^Vl, Rb^Gvs, Rb^Gvs, Rb^Gvs, Rb^Gvs, Rb^Gvs, Rb^Gvs, Hh, Mm, Mm, Mm, Mm, Mm, Hh
Gg, Gg, Gg, Mm, Gg, Mm, Rb^Gvs, Rb^Gvs, Rb^Gvs, Rb^Gvs, Rb^Gvs, Rb^Gvs, Rb^Gvs, Rb^Gvs, Rb^Gvs, Rb^Gvs, Rb^Gvs, Rb^Gvs, Rb^Gvs, Rb^Gvs, Rb^Gvs, Re, Re, Gg^Vh, Gg, Rb^Gvs, Rb^Gvs, Rb^Gvs, Rb^Gvs, Rb^Gvs, Rb^Gvs, Rb^Gvs, Rb^Gvs, Rb^Gvs, Rb^Gvs, Rb^Gvs, Rb^Gvs, Wo, Ww, Ww, Gg, Rrc, Rrc, Rrc, Rrc, Rb^Gvs, Mm, Rb^Gvs, Hh, Rb^Gvs, Rb^Gvs, Hh, Gg, Mm, Mm, Mm, Gg, Hh
