border_size=1
usage=map

Gd, Gd, Gd, Gd, Hhd, Mm, Mm, Mm, Mm, Mm, Hh^Fp, Hh^Fp, Gs^Fp, Gs^Fp, Gs^Fp, Gs^Fp, Gs^Fp, Gs^Fp, Gg^Efm, Gs^Fp, Gs^Fp, Gs^Fp, Gs^Fp, Gs^Fp, Gs^Fp, Gs^Fp, Re, Gs^Fp
Gd, Gd, Gs, Hhd, Md, Mm, Mm, Mm, Hh^Fp, Hh^Fp, Gs^Fms, Hh^Fds, Gs^Fds, Gs^Fp, Gll^Fp, Gs^Fms, Gs^Fms, Gs^Fp, Gs^Fp, Gs^Fp, Gs^Fp, Gs^Fp, Gs^Fp, Gs^Fp, Gs^Fp, Gs^Fp, Re, Gs^Fp
Gd, Gd, Gs, Gs, Hh^Fp, Hh^Vhh, Hh^Fp, Mm, Hh^Fds, Hh^Fds, Gs^Fp, Hh^Fms, Hh^Fms, Gs^Fp, Gs^Fp, Gll^Fp, Gg, Gs^Fp, Gs^Fp, Gs^Fp, Gs^Fms, Gs^Fp, Gs^Fp, Gs^Fms, Gs^Fp, Hh^Fp, Re, Gs^Fp
Hhd, Gs, Gs, Hh, Hh, Hh, Gg, Hh^Fp, Gs^Fp, Gs^Fp, Gs^Fp, Gs^Fp, Gs^Fp, Gg^Ve, Gs^Fp, Gg^Fet, Gs^Fms, Gs^Fms, Gs^Fp, Gg^Efm, Gs^Fms, Gs^Fp, Gs^Fp, Gs^Fp, Gs^Fp, Re, Gs^Fp, Gs^Fp
Md, Hh, Hh, Mm, Mm, Hh^Fp, Hh^Fp, Gs^Fp, Gs^Fp, Gs^Fp, Gs^Fp, Gs^Fp, Gs^Fp, Hh^Fms, Gs^Fp, Gs^Fp, Gs^Fp, Gs^Fp, Gg^Fet, Gs^Fms, Gs^Fms, Gs^Fp, Gg^Ve, Gs^Fp, Re, Re, Gs^Fp, Gs^Fds
Mm, Chr, Chr, Mm, Mm, Mm, Hh^Fds, Gs^Fp, Gs^Fp, Gs^Fp, Gs^Fp, Gs^Fp, Gs^Fp, Gs^Fms, Gs^Fp, Gs^Fp, Gs^Fp, Gs^Fp, Gg^Fet, Gg^Fet, Gg^Fet, Gs^Fp, Hh^Fp, Gs^Fp, Re, Gs^Fms, Gs^Fms, Gs^Fms
Mm, Khr, Mm, Mm, Mm, Mm, Hh^Fms, Gs^Fp, Gs^Fp, Gs^Fp, Gs^Fp, Gg^Fet, Gs^Fp, Gs^Fp, Gg^Efm, Gg^Efm, Gs^Fp, Gg^Fet, Gs^Fp, Gg^Fet, Gs^Fp, Gs^Fp, Gs^Fp, Hh^Fp, Re, Gs^Fp, Gs^Fp, Gs^Fms
Mm, Mm, Mm, Mm, Mm, Hh^Fp, Hh^Fms, Gs^Fp, Gs^Fp, Gs^Fp, Gs^Fp, Gs^Fp, Gs^Fp, Gs^Fp, Gs^Fp, Gs^Fp, Gs^Fms, Gs^Fp, Gs^Fp, Gs^Fp, Gs^Fp, Gs^Fp, Ke, Re, Gs^Fms, Gs^Fds, Gs^Fp, Gs^Fms
Mm, Mm, Hh^Vhh, Mm, Mm, Hh^Fp, Hh^Fp, Hh^Fds, Gs^Fp, Gs^Fp, Gs^Fms, Gs^Fms, Gs^Fp, Gs^Fp, Gs^Fms, Gs^Fp, Gs^Fp, Gs^Fp, Hh^Fp, Gg^Ve, Gs^Fp, Ce, Ce, Ce, Gs^Fp, Gs^Fp, Gs^Fms, Gs^Fp
Mm, Mm, Mm, Mm, Mm, Mm, Mm, Hh^Fp, Hh^Fds, Gs^Fp, Gs^Fp, Gs^Fp, Gs^Fp, Gg^Ve, Gs^Fms, Gs^Fms, Gg^Fet, Gs^Fms, Hh^Fp, Gs^Fp, Gs^Fp, Ce, Gs^Fp, Ce, Gs^Fp, Gs^Fp, Gs^Fp, Gs^Fds
Mm, Mm, Mm, Mm, Mm, Mm, Mm, Mm, Hh^Fp, Gs^Fp, Gs^Fp, Gs^Fp, Gs^Fp, Gs^Fp, Gs^Fp, Gs^Fp, Gs^Fp, Gs^Fp, Gs^Fp, Gs^Fp, Gs^Fp, Gs^Fds, Gs^Fp, Gs^Fp, Gs^Fp, Gs^Fp, Gg^Fet, Gs^Fp
Hh, Hh, Hh, Mm, Mm, Mm, Mm, Mm, Mm, Hh^Fp, Hh^Fp, Hh^Fp, Hh^Fp, Gs^Fp, Gs^Fp, Gs^Fp, Hh^Fds, Gs^Fms, Gs^Fp, Gg^Efm, Gs^Fp, Gs^Fp, Gs^Fms, Gs^Fp, Gs^Fp, Gs^Fp, Gs^Fp, Gs^Fp
Gs, Gs, Hh, Gg, Mm, Mm, Mm, Mm, Mm, Gg, Gs^Fp, Hh^Fp, Gs^Fp, Gs^Fp, Hh^Fp, Gs^Fp, Hh^Fds, Gs^Fp, Gs^Fp, Gs^Fp, Gs^Fp, Gs^Fp, Gs^Fp, Gs^Fp, Gg^Efm, Gs^Fp, Gs^Fp, Gs^Fp
Gs, Gg, Gs, Gs, Hh, Hh, Hh^Vhh, Mm, Mm, Hh^Fp, Gg, Gs^Fp, Gs^Fp, Gs^Fp, Hh^Fp, Hh^Fms, Hh^Fp, Gs^Fms, Gs^Fms, Gg^Fet, Gg^Fet, Gs^Fp, Gs^Fms, Gs^Fp, Gll^Fp, Gs^Fp, Gs^Fp, Gs^Fms
Gs, Gs, Gs, Gg, Gs, Gs, Hh, Mm, Hh^Fp, Gg, Gg, Gg, Gg, Gs^Fp, Gs^Fp, Hh^Fms, Gs^Fp, Gs^Fp, Gs^Fms, Gs^Fp, Gs^Fp, Gs^Fp, Gs^Fms, Gs^Fp, Gll^Fp, Gs^Fms, Gg, Gs^Fms
Gs, Gs, Gg, Gg, Hh, Gs, Gs, Hh, Gg, Gg, Gg, Gs^Fms, Gg, Gg^Efm, Gs^Fp, Gs^Fp, Gs^Fp, Hh^Fms, Gs^Fp, Gs^Fp, Gs^Fp, Gs^Fp, Gs^Fms, Gs^Fds, Gs^Fp, Gll^Fp, Gs^Fp, Gs^Fms
Gs, Gs, Gg, Gg, Mm, Hh^Fp, Hh^Fms, Gg, Gg, Gs^Fms, Gg, Gg, Gg, Gg, Gs^Fp, Gs^Fp, Hh^Fms, Hh^Fms, Gs^Fp, Gs^Fms, Gs^Fp, Gg^Fet, Gg^Ve, Gs^Fp, Gs^Fp, Gs^Fp, Gs^Fp, Gs^Fp
Gs, Hh, Mm, Mm, Mm, Mm, Gg, Gg, Gg, Gg, Gg, Gs^Fms, Gg, Gg, Gg, Hh^Fms, Gs^Fp, Gs^Fp, Gs^Fp, Gs^Fp, Gs^Fp, Gs^Fp, Gs^Fp, Gs^Fms, Gs^Fp, Gs^Fp, Gs^Fp, Gs^Fms
Hh, Hh, Mm, Mm, Hh^Vhh, Hh^Fp, Gg, Gg, Gg, Gg, Gg, Gg, Gs^Fp, Gs^Fp, Gg, Hh^Fms, Gs^Fp, Gs^Fp, Gg^Fet, Gs^Fp, Gs^Fms, Gs^Fp, Gs^Fp, Gs^Fms, Gs^Fms, Gs^Fp, Gg^Fet, Gs^Fms
Mm, Mm, Mm, Mm, Hh, Gg, Hh, Hh^Fp, Hh^Fp, Gg, Hh^Fp, Gg, Gg, Hh^Fms, Gg, Gg, Gs^Fp, Gs^Fp, Gs^Fp, Gs^Fp, Gg^Efm, Gg^Efm, Gs^Fp, Gs^Fp, Gs^Fms, Gs^Fp, Gs^Fds, Gg^Fet
Mm, Mm, Mm, Mm, Gg, Gg, Hh, Hh^Fms, Hh, Hh, Hh, Gg, Gg, Gg, Gg, Gg, Gg, Gs^Fp, Gs^Fp, Gs^Fp, Gs^Fp, Gs^Fp, Gs^Fp, Gs^Fp, Gs^Fp, Gs^Fms, Gs^Fms, Gs^Fp
Mm, Mm, Mm, Mm, Gg, Gg, Gg, Hh, Hh, Hh, Hh, Gg, Gg, Gg, Gs^Fp, Gg, Gg, Gs^Fp, Gs^Fp, Gs^Fp, Gs^Fp, Gs^Fp, Gs^Fp, Gs^Fp, Gg^Fet, Gg^Fet, Gs^Fp, Gs^Fms
Mm, Mm, Mm, Hh^Fms, Hh^Fp, Gg, Gg, Gg, Hh, Hh^Fp, Hh^Fms, Gg, Gg, Gg, Gg, Gg, Gg, Gg, Gs^Fp, Gs^Fp, Gs^Fms, Hh^Fms, Hh^Fms, Gs^Fp, Gs^Fms, Gs^Fp, Gs^Fms, Gs^Fms
Ms, Ms, Mm, Hh^Fp, Gg, Hh, Hh, Gg, Hh, Hh, Hh^Fp, Gg, Gg, Gg, Gg, Gg, Gg, Gg, Gg, Gs^Fp, Gs^Fp, Gs^Fp, Gs^Fp, Gs^Fms, Gs^Fp, Gs^Fms, Gs^Fp, Gg^Ve
Ms, Mm, Mm, Hh, Hh^Fp, Hh, Gg, Hh, Mm, Mm, Mm, Hh^Fp, Gg, Gg, Gg, Gg, Gg, Gg, Gs, Gg, Gg, Gs^Fp, Gg, Gs^Fp, Gg^Efm, Gs^Fp, Hh^Fms, Gs^Fds
Mm, Mm, Gs, Mm, Hh^Fp, Gg, Gg, Hh^Vhh, Mm, Mm, Mm, Gg, Gg, Gg, Gg, Gg, Gs, Gg, Gg, Gg, Gg, Gg, Gg, Gg, Gg, Gs^Fp, Gs^Fp, Gs^Fp
Mm, Mm, Gg, Gs, Gg, Gg, Hh, Hh^Fp, Hh^Fms, Mm, Gg, Gg, Gs, Gg, Gg, Gg, Gs, Gg, Gs, Gs, Gs^Fp, Gg, Gg, Gg, Gs, Gg, Gg, Gs^Fp
Mm, Mm, Hh, Gg, Hh, Hh, Mm, Hh, Hh, Hh, Gs, Gs, Gs, Gg, Hh^Fp, Gg, Gs^Fp, Gs, Gg, Gg, Hh^Fp, Gs^Fp, Gs^Fp, Gg, Gg, Gg, Hh^Fp, Hh^Fp
Hh, Hh^Vhh, Hh, Hh, Gg, Mm, Hh^Fp, Hh, Hh, Gg, Gs, Gs, Gs, Gg, Gs^Fp, Hh^Fp, Gg, Gg, Gg, Gg, Gs^Fp, Gs, Gg, Gg, Gs^Fp, Gg, Hh^Fp, Ms
Mm, Hh, Hh^Fp, Mm, Mm, Mm, Mm, Hh, Gs, Gs, Gg, Gg, Gs, Gg, Gg, Gg, Gg, Gg, Gg, Gs^Fp, Hh^Fp, Gg, Gs^Fp, Gs^Fp, Gg, Hh^Fp, Mm^Xm, Mm^Xm
Hh, Hh^Fp, Hh^Fms, Hh^Fms, Hh, Hh, Hh, Hh, Gg, Gg, Gs, Gg, Gg, Gg, Gg, Gs^Fp, Hh^Fp, Gg^Vc, Hh, Hh^Fp, Hh^Fmw, Gs^Fp, Gs, Gg, Gg, Hh^Fp, Mm^Xm, Mm
Hh, Mm, Hh, Mm, Hh, Hh, Gg, Gg^Efm, Gs, Gg, Hh^Fp, Gs^Fp, Gg^Efm, Gg, Gg, Hh, Hh, Hh, Ms, Mm, Hh, Gs, Gg, Gg, Gg, Gg, Mm^Xm, Mm
Hh, Hh^Fp, Hh^Fms, Hh, Gg, Gg, Gg, Gg, Gg, Gs, Gg, Gg, Gg, Gg, Gg^Efm, Gg, Hh^Fp, Mm, Mm^Xm, Mm, Hh^Vhh, Gg, Gs, Gg, Hh, Mm, Mm, Mm^Xm
Gg, Hh, Hh, Hh^Fp, Hh^Fms, Gg, Gg, Hh, Hh, Hh, Gg^Efm, Gg, Gg, Hh, Hh, Hh, Mm, Mm^Xm, Mm, Gg, Gs, Gg, Gs, Gg, Hh, Hh^Fp, Mm, Mm
Mm, Mm, Mm, Gg, Hh, Hh^Fms, Hh^Vhh, Mm, Gg, Gs, Gg, Gs, Gg, Gg, Gg^Efm, Mm, Mm^Xm, Mm^Xm, Hh^Fms, Hh, Hh, Gg, Gg, Gg, Hh, Hh^Fdw, Mm, Mm
Hh^Vhh, Mm, Hh, Mm, Hh, Hh, Hh, Ce, Ke, Gg, Gg, Gs, Gg, Hh, Mm, Mm, Mm^Xm, Mm, Hh^Fdw, Hh, Gg, Gg^Efm, Gg, Gg^Efm, Mm, Gg, Mm^Xm, Mm^Xm
Hh, Hh, Hh^Fms, Mm, Hh, Mm, Gg, Ce, Ce, Ce, Gg^Efm, Gg, Hh, Hh, Mm, Ms, Ms, Mm^Xm, Mm, Gg, Gs, Gg, Gg, Hh, Hh^Vhh, Mm^Xm, Mm, Mm
Ss, Gg, Gg, Gg, Gg, Hh, Gg, Gg, Gg, Gg, Gg, Gg, Hh^Vhh, Mm, Ww, Ms, Mm, Mm^Xm, Mm, Hh, Gs, Gg, Gg, Hh, Mm, Mm^Xm, Mm^Xm, Mm
Ss, Ss, Ss, Hh, Ss, Gg^Efm, Gg, Gg, Gg, Gg, Gg, Hh, Ss, Gg, Wwf, Mm, Mm, Mm^Xm, Mm^Xm, Mm, Hh, Gg, Gg, Gg, Mm, Mm, Mm^Xm, Mm
Gg, Gg, Gg, Gg, Gg, Gg, Gg, Ss, Gg, Ss, Gg, Gg, Ss, Ss, Gg, Ss, Ss, Mm, Mm, Mm^Xm, Mm, Gg, Gg, Gg, Mm, Mm^Xm, Mm, Hh
Ss, Ss, Gg, Ss, Ss, Ss, Ss, Ss, Ss, Gg, Ss, Ss, Wo, Ww, Ww, Ss, Ss, Hh, Mm, Mm^Xm, Mm^Xm, Mm, Mm, Gg, Mm, Mm^Xm, Mm, Gs^Fp
Ss, Gg, Gg^Efm, Gg^Efm, Ss, Ss, Gg, Gg, Ss, Ds, Ww, Wo, Ss, Ss, Ww, Ss, Ww, Hh, Ss, Hh, Hh, Mm^Xm, Mm, Hh, Hh, Mm^Xm, Mm, Gg
Ss, Gg, Ss^Vhs, Ss, Ss, Gg^Efm, Gg, Ss^Vhs, Ss, Ww, Ww, Ss, Ss, Ww, Gg, Ss, Gg, Ss, Wwf, Ww, Hh, Mm^Xm, Mm, Hh, Hh, Mm^Xm, Mm, Gg
