border_size=1
usage=map

Gg, Ss, Gg, Ss, Gg, Ss, Gg, Gg, Gg, Ww, Gg, Hh, Gg, Gg, Mm, Mm, Hh, Hh^Fp, Hh^Fms, Hh, Gg, Gg, Gg, Gg, Gg, Gs, Gg, Gg, Gg, Gg, Gg^Efm, Gg, Hh^Fp, Mm, Mm^Xm, Mm, Hh^Vhh, Gg, Gs, Gg, Hh, Mm, Mm, Mm^Xm, Mm^Xm
Ww, Gg, Gg, Gg, Gg, Ss, Gg, Ss, Wo, Ww, Gg, Hh, Hh, Hh, Mm, Mm, Gg, Hh, Hh, Hh^Fp, Hh^Fms, Gg, Gg, Hh, Hh, Hh, Gg^Efm, Gg, Gg, Hh, Hh, Hh, Mm, Mm^Xm, Mm, Gg, Gs, Gg, Gs, Gg, Hh, Hh^Fp, Mm, Mm, Mm^Xm
Ww, Wo, Ww, Ss^Vhs, Ss, Gg, Gg, Gg, Ww, Gg, Gg, Gg, Hh, Hh, Hh, Mm, Mm, Mm, Mm, Gg, Hh, Hh^Fms, Hh^Vhh, Mm, Gg, Gs, Gg, Gs, Gg, Gg, Gg^Efm, Mm, Mm^Xm, Mm^Xm, Hh^Fms, Hh, Hh, Gg, Gg, Gg, Hh, Hh^Fdw, Mm, Mm, Mm^Xm
Ww, Gg, Ww, Gg, Ss, Ss, Ss, Ss, Ww, Ss, Gg, Gg, Gg, Gg, Hh, Hh, Hh^Vhh, Mm, Hh, Mm, Hh, Hh, Hh, Ce, Ke, Gg, Gg, Gs, Gg, Hh, Mm, Mm, Mm^Xm, Mm, Hh^Fdw, Hh, Gg, Gg^Efm, Gg, Gg^Efm, Mm, Gg, Mm^Xm, Mm^Xm, Hh^Fp
Wo, Ww, Ww, Ss, Gg, Ss, Ss, Ss, Ss, Ww, Gg^Vc, Ss, Ss, Gg, Gg, Gg, Hh, Hh, Hh^Fms, Mm, Hh, Mm, Gg, Ce, Ce, Ce, Gg^Efm, Gg, Hh, Hh, Mm, Ms, Ms, Mm^Xm, Mm, Gg, Gs, Gg, Gg, Hh, Hh^Vhh, Mm^Xm, Mm, Mm, Mm^Vc
Wo, Wo, Gg, Ww, Ww, Gg, Ss, Sm, Wo, Ww, Ss, Gg, Gg, Gg, Ss, Gg, Ss, Gg, Gg, Gg, Gg, Hh, Gg, Gg, Gg, Gg, Gg, Gg, Hh^Vhh, Mm, Ww, Ms, Mm, Mm^Xm, Mm, Hh, Gs, Gg, Gg, Hh, Mm, Mm^Xm, Mm^Xm, Mm, Hh
Ww, Ww, Ww, Ww, Wo, Ww, Wo, Ss, Ww, Ww, Ww, Ss, Ss, Ss, Gg, Gg, Ss, Ss, Ss, Hh, Ss, Gg^Efm, Gg, Gg, Gg, Gg, Gg, Hh, Ss, Gg, Wwf, Mm, Mm, Mm^Xm, Mm^Xm, Mm, Hh, Gg, Gg, Gg, Mm, Mm, Mm^Xm, Mm, Hh
Gg, Ww, Gg, Gs, Gg, Wo, Ww, Ww, Gg, Ss, Ss, Ss, Ss, Ww, Ss, Ss, Gg, Gg, Gg, Gg, Gg, Gg, Gg, Ss, Gg, Ss, Gg, Gg, Ss, Ss, Gg, Ss, Ss, Mm, Mm, Mm^Xm, Mm, Gg, Gg, Gg, Mm, Mm^Xm, Mm, Hh, Hh
Gg, Ss, Gg, Gg, Gg, Ss, Ww, Ww, Gg, Gg, Ss, Gg, Ww, Wo, Ww, Gg, Ss, Ss, Gg, Ss, Ss, Ss, Ss, Ss, Ss, Gg, Ss, Ss, Wo, Ww, Ww, Ss, Ss, Hh, Mm, Mm^Xm, Mm^Xm, Mm, Mm, Gg, Mm, Mm^Xm, Mm, Gs^Fp, Hh^Fmw
Gg, Gg, Ss, Ss, Gg, Ss^Vhs, Ww, Wo, Ww, Ss, Ss^Vhs, Ss, Ss, Wo, Ww, Ss, Ss, Gg, Gg^Efm, Gg^Efm, Ss, Ss, Gg, Gg, Ss, Ds, Ww, Wo, Ss, Ss, Ww, Ss, Ww, Hh, Ss, Hh, Hh, Mm^Xm, Mm, Hh, Hh, Mm^Xm, Mm, Gg, Hh^Fmw
Gg, Gg, Gg, Ss, Gg, Ss, Ss, Wo, Wo, Ww, Ss, Ss, Wwf, Ww, Ss, Gg, Ss, Gg, Ss^Vhs, Ss, Ss, Gg^Efm, Gg, Ss^Vhs, Ss, Ww, Ww, Ss, Ss, Ww, Gg, Ss, Gg, Ss, Wwf, Ww, Hh, Mm^Xm, Mm, Hh, Hh, Mm^Xm, Mm, Gg, Gg
Gg, Ss, Ss, Gg, Gg, Gg, Gg, Gg, Ww, Wo, Wo, Sm, Ss, Ss, Ss, Sm, Ss, Ss, Gg, Ww, Ss, Gg, Gg, Gg, Gg, Ww, Ww, Gg, Ss, Ww, Ww, Ss, Ww, Ww, Gs^Fp, Gs^Fp, Chr, Mm, Hh^Fp, Mm, Mm^Xm, Mm^Xm, Mm, Gg^Efm, Mm
Ss, Ss, Ss, Gg, Ss, Gg, Ss, Ss, Ss, Ww, Wo, Ss, Gg, Ww, Ss, Ww, Ss, Ss, Gg, Gg, Ss, Ss, Ww, Ss, Ss, Ww, Gg, Ss, Ss, Ss, Ww, Ss^Vhs, Ss, Ww, Gg, Gs^Fp, Chr, Khr, Mm^Vhh, Mm, Mm^Xm, Mm, Mm, Hh, Ms
Ss, Gg, Ss, Ss, Gg, Ss, Sm, Ss, Ss, Ww, Ww, Ww, Ss, Gg, Gg, Gg, Gg, Ss, Gg, Ss, Gg^Efm, Gg, Ss, Ss, Wo, Ww, Gg, Ss, Gg, Ss, Ww, Ww, Ss, Gg, Rb, Gs, Hh, Chr, Hh^Fmw, Mm, Mm, Mm^Xm, Mm^Xm, Mm, Mm
Gg, Ss, Gg, Hh, Ss, Ss, Ss, Gg, Gg, Ww, Ww, Wo, Gg, Ss, Ss, Gg, Ss, Gg, Ss, Ss, Chs, Gg, Ds, Wo, Ww, Ss, Ss^Vhs, Gg^Efm, Gg, Ds, Wo, Gg, Ss, Gg, Rb, Hh^Fp, Hh^Fms, Gg, Hh^Fmw, Mm, Mm, Mm^Xm, Mm, Mm, Mm
Rb, Rb, Rb, Rb, Rb, Gg, Hh, Ss, Gg, Wo, Wo, Ww, Wo, Ss, Ss^Vhs, Gg, Ss, Ww, Gg, Ss, Chs, Gg, Wo, Wo, Ss, Ss, Ss, Ss, Ss, Gs, Ww, Ss, Rb, Rb, Gg, Gg, Gg, Gg^Efm, Mm^Vhh, Hh, Mm^Xm, Mm^Xm, Mm, Mm, Mm
Hh, Ss, Ss, Gg, Hh, Rb, Rb, Gg, Ss, Ss, Ww, Ww, Ww, Wo, Ss, Gg, Gg, Gg, Ss, Gg, Khs, Chs, Ww, Ww, Rb, Rb, Rb, Rb, Rb, Re, Ww, Rb, Gg^Efm, Ss, Ss, Gg, Gg^Efm, Hh, Hh, Hh, Mm, Mm^Xm, Mm^Xm, Mm, Hh^Fms
Hh, Hh, Gs, Gg, Hh, Ch, Gg, Rb, Gg, Ss, Ss, Ww, Wo, Ww, Ww, Ss, Ss, Ss, Gg, Gg^Efm, Gg, Ss^Vhs, Rb, Ww, Ss, Ss, Ss, Ss, Gg, Ss, Ww, Gg, Gg^Efm, Gg, Gg, Gg^Efm, Hh^Fms, Gg^Efm, Gg^Efm, Hh, Mm, Mm, Mm, Mm, Ke
Gg, Gg, Gg, Hh, Hh, Ch, Ch, Rb, Gg, Ss, Gg, Gg, Ww, Ww, Ww, Gg, Ss, Ss, Gg, Ss, Rb, Rb, Gg, Ww, Ww, Gg, Ss, Ds, Ds, Ss, Ww, Ww, Ds, Ds, Ss, Hh, Gg, Gg, Gg, Hh, Hh, Mm, Mm, Mm, Ce
Mm, Mm, Hh, Hh^Vhh, Mm, Kh, Ch, Re, Rb, Gg, Wo, Ww, Gg, Ww, Ww, Gg, Ss, Ss, Rb, Rb, Ss, Gg^Efm, Ds, Ds, Ww, Ss, Wo, Wo, Ww, Ww, Ww, Ww, Gg, Gg, Gg, Hh, Gg, Gg, Gg^Efm, Gg^Efm, Hh, Hh^Fds, Mm, Mm, Gg
Wo, Mm, Wo, Mm, Mm, Gs, Ds, Gg, Gg, Ww^Bw\, Rb, Gg, Gg, Ww, Ww, Wo, Rb, Rb, Ss^Vhs, Gg, Ss, Ss, Ds, Ds, Ww, Ww, Ww, Ww, Ss, Ww, Ds, Ds, Ww, Ww, Gg, Gg, Gg, Gg, Wo, Gg^Efm, Gg, Hh^Fds, Hh, Mm, Gg
Ww, Ww, Ww, Wo, Wwr, Wwf, Ww, Ww, Ww, Ww, Gs, Re, Re, Gs, Wwf, Wwf, Gg, Ss, Ss, Ss, Gg, Gg, Ww, Ww, Ww, Ww, Ww, Ww, Ss, Gg^Efm, Ww, Ww, Wo, Ww, Ww, Gg, Ww, Ds, Gg^Efm, Gg^Vht, Gg, Gg, Gg, Hh, Ds
Ww, Ww, Wo, Wo, Wwf, Ww, Wo, Ww, Wwf, Ww, Ds, Gs, Gs, Re, Wo^Bw\, Ww, Ww, Ss, Ss, Ds, Ww, Ww, Wo, Wo, Ww, Ds, Ww, Ss^Vm, Ww, Ww, Wo, Ww, Wo, Wo, Wo, Ww, Wo, Ww, Ww, Ds, Ds, Ds, Ww, Ww, Wo
Wo, Ww, Ww, Ww, Ww, Wwr, Wo, Ww, Wwr, Ww, Ww, Ds, Wo, Ds, Ww, Wo, Wo, Ss, Ww, Ww, Ww, Ww, Wo, Ww, Ww, Ww, Ww, Ww, Ww, Wo, Wo, Wo, Wo, Wo, Wo, Wo, Wo, Wo, Wo, Ww, Wwr, Ww, Ww, Ww, Wo
Ww, Wo, Wo, Wo, Wo, Wwf, Wwr, Wo, Wo, Ww, Wo, Wo, Wo, Ww, Wo, Wo, Ww, Ww, Wo, Wo, Wo, Wo, Wo, Wo, Ww, Wo, Ww, Ww, Wwr, Ww, Wo, Wo, Wo, Wo, Ww, Wo, Ww, Wo, Wo, Ww, Wwr, Ww, Wo, Ww, Wo
Wo, Wo, Wo, Wo, Wwr, Wo, Wwr, Ww, Ww, Wo, Wwr, Ww, Wo, Wo, Wo, Ww, Wo, Ww, Wo, Wo, Wo, Wo, Wo, Ww, Ds, Ww, Ww, Wo, Ww, Wo, Wo, Wo, Wo, Wo, Wo, Wo, Wo, Wo, Wo, Wo, Wo, Wo, Wo, Wo, Wwr
Wo, Wo, Wo, Hh, Wwr, Wo, Wo, Wo, Wo, Wo, Wo, Wwf, Wo, Wo, Wo, Ww, Wo, Wo, Wo, Wo, Wo, Wo, Wwr, Ww, Gs, Ww, Wo, Ww, Wo, Wo, Wo, Wo, Wo, Wo, Wo, Wo, Wo, Wo, Wo, Wo, Wo, Wo, Ww, Wwr, Wo
Wo, Wo, Wo, Gs, Gs^Vc, Wo, Wo, Wo, Wo, Wo, Wo, Wo, Wo, Wo, Wo, Wo, Wo, Wo, Wo, Wo, Wo, Wo, Wwr, Ww, Wo, Wo, Wwr, Wo, Wo, Wo, Wo, Wo, Wo, Wo, Wo, Wo, Wo, Wo, Wo, Wo, Gg, Ww, Wo, Wo, Wo
Ww, Wo, Ww, Ds, Gs, Wo^Bw\, Wo, Wo, Wo, Wo, Wo, Wo, Wo, Wo, Wo, Wo, Wo, Wo, Wo, Wo, Wo, Wo, Wwr, Ww, Ww, Ww, Wo, Wo, Wo, Wo, Wo, Wo, Wo, Wo, Wo, Wo, Wo, Wo, Hh, Gg, Hh, Gg, Ds, Wo, Wo
