border_size=1
usage=map

Hh, Gg, Mm, Hh, Mm, Mm^Xm, Mm^Xm, Hh, Ww, Ww, Ww, Ds, Gs, Gg, Gg, Rb^Gvs, Rb^Gvs, Gg, Gs, Gg, Gg, Gg, Ds, Ds, Gs, Wo, Ww, Gg, Gs, Ww, Gg, Gg, Gg, Gg
Gg^Vc, Mm, Hh, Hh, Hh, Mm, Ms^Xm, Hh, Wo, Wo, Wo, Ds, Gs, Gg, Gs, Rb^Gvs, Gs, Gs, Gs, Gs, Gg, Gg, Ww, Ww, Gg, Wo, Ww, Wo, Gg, Ww, Ww, Gg^Vc, Gg, Gs
Wo, Gg, Ss, Hh, Hh^Vhh, Ms, Mm^Xm, Mm, Wo, Wo, Ww, Gg, Gg, Gg, Gg, Gg, Gg, Gg, Ds, Gs, Gg, Gg^Vc, Ww, Wo, Wo, Gg, Wo, Ww, Wo, Wo, Wo, Gg, Gg, Gs
Ss, Wo, Ww, Wo, Ww, Wo, Mm, Mm^Xm, Mm^Xm, Wo, Wo, Gg, Ds, Gg, Gg, Gg, Gs, Gs, Wo, Ds, Wo, Wo, Ww, Wo, Wo, Wo, Wo, Wo, Wo, Ww, Wo, Ww, Wo, Ds
Gg, Wo, Ww, Ss, Hh, Hh, Mm, Mm, Mm^Xm, Wo, Wo, Wo, Wo, Wo, Wo, Wo, Wo, Wo, Wo, Wo, Wo, Wo, Wo, Wo, Wo, Wo, Wo, Wo, Wo, Wo, Wo, Wo, Wo, Wo
Ss, Ww, Ww, Ss, Mm, Hh, Mm^Xm, Mm^Xm, Hh, Ww, Wo, Hh, Gg, Wo, Gg, Wo, Wo, Wo, Gg, Wo, Wo, Wo, Wo, Wo, Wo, Ww, Ww, Ww, Wo, Wo, Wo, Wo, Wo, Wo
Hh, Hh, Ww, Gg, Hh, Hh^Vhh, Mm^Xm, Mm, Wo, Wo, Wo, Wo, Ds, Gg, Wo, Wo, Gs, Wo, Gg^Vc, Wo, Wo, Ww, Wo, Ww, Ww, Wo, Ww, Wo, Wo, Wo, Ww, Wo, Wo, Wo
Mm, Mm, Wo, Hh, Mm, Mm^Xm, Mm, Mm^Xm, Mm^Xm, Wo, Wo, Wo, Hh, Gg, Gg, Gg, Gg, Gs, Gg, Wo, Wo, Wo, Wo, Wo, Wo, Wo, Wo, Wo, Ww, Gg, Gg, Ww, Ss, Gg
Mm^Xm, Mm^Xm, Ms^Xm, Wo, Hh, Mm^Xm, Wo, Ms^Xm, Ms^Xm, Gg, Wo, Wo, Wo, Wo, Wo, Gg, Wo, Gg, Wo, Wo, Ww, Ww, Wo, Wo, Wo, Wo, Gg, Ss, Sm, Ss^Vhs, Ww, Ww, Ww, Ss
Hh, Hh, Ha^Vhha, Ww, Wo, Wo, Ms, Ha, Mm^Xm, Wo, Ww, Ww, Wo, Wo, Wo, Wo, Wo, Wo, Wo, Wo, Wo, Ww, Wo, Ww, Ww, Gg, Ss, Ss, Wo, Ss, Ss, Ss, Sm, Ss
Hh, Mm, Hh, Mm^Xm, Mm, Wo, Wo, Wo, Mm^Xm, Wo, Wo, Wo, Wo, Wo, Hh, Gg, Gg, Wo, Wo, Wo, Wo, Wo, Ss, Ww, Gg, Wo, Ss, Ss, Ss, Ww, Chs, Ww, Gg, Ss
Mm^Xm, Mm^Xm, Hh, Mm, Mm^Xm, Mm^Xm, Ww, Mm^Xm, Mm^Xm, Wo, Wo, Wo, Wo, Hh, Gg, Gg, Ss^Vhs, Wo, Ss, Ss, Ww, Ss, Ss, Ds, Ss, Ww, Ss, Ww, Ss, Chs, Chs, Khs, Ss, Gg
Hh, Hh, Gg, Gs, Hh, Mm^Xm, Mm^Xm, Mm^Xm, Hh, Wo, Hh, Hh, Wo, Hh, Gg, Ss, Ss, Ss, Ww, Ss, Ww, Ss, Ww, Ww, Ss, Ss, Ss, Ww, Ss, Chs, Ss, Chs, Ww, Ww
Mm, Mm, Gs, Gs, Hh, Mm^Xm, Mm^Xm, Mm, Hh, Mm, Hh, Wo, Hh, Gg, Gg, Gg, Ss, Ww, Gg, Ss, Ss, Ss^Vhs, Ss, Ss, Ss, Sm, Ww, Ss, Ss, Ss, Gg^Efm, Ss, Ss, Gg
Mm, Hh, Gg, Hh, Mm, Mm^Xm, Hh, Mm, Mm, Hh, Mm, Hh, Gs, Gg, Gg, Ss, Gg, Ss, Ss, Gg, Sm, Ww, Ss, Gg, Ss, Ss, Ss, Ss, Wo, Ss, Ss, Ww, Ss, Ss
Gg, Gg, Mm, Mm, Mm^Xm, Mm^Xm, Mm^Xm, Mm, Mm, Mm, Hh, Gs, Gg, Gg, Gg, Gg, Gg, Gg, Gg, Gg, Ss, Ss, Ss, Ss, Ss, Gg, Ss, Ss, Ss, Ss, Sm, Ss, Ss, Ss
Hh, Mm^Xm, Mm^Xm, Mm^Xm, Mv, Md^Xm, Mm^Xm, Hh, Mm^Xm, Hh, Mm, Gs, Hh, Hh, Mm, Gg, Gg, Gg, Gg, Ss, Wo, Ss, Wo, Ww, Ss, Gg^Efm, Ss, Ww, Gg, Ww, Ss, Ww, Ss^Vhs, Ss
Hh, Mm, Md^Xm, Mm, Uh, Uh, Hhd, Mm^Xm, Md, Mm^Xm, Hh, Gs, Mm^Xm, Mm, Mm^Xm, Hh, Gg, Ss, Gg, Gg, Ss, Ss, Ss, Ss, Gg, Ss, Gg, Ss, Ww, Ww, Ss, Ss, Ww, Ss
Gg, Mm, Md^Xm, Md^Xm, Md, Uh, Uh, Uh, Rd^Vhr, Mm^Xm, Mm^Xm, Mm^Xm, Md, Mm^Xm, Wo, Mm, Gg, Gg, Gg, Ss, Gg, Gg, Gg, Gg, Gg, Gg, Ww, Ss, Ss, Ss, Ss, Gg, Ss, Ss
Hh, Hh, Md^Xm, Md^Xm, Hhd, Uh, Uh, Rd, Uh, Hhd, Hhd, Md, Md, Mm^Xm, Mm^Xm, Mm, Mm, Gs, Gg, Gg, Gg, Gg, Gg, Gg, Ss, Gg, Ss, Ss, Ss, Gg, Gg, Ss, Gg, Gg
Mm^Xm, Mm^Xm, Rd^Vhr, Hhd, Rd^Es, Uh, Uh, Rd, Uh, Uh, Rd^Dr, Hhd, Hhd, Rd^Vhr, Mm^Xm, Mm^Xm, Mm^Xm, Hh, Hh, Gg, Gg, Ss, Gg, Gg, Gg, Gg, Ss, Gg, Gg, Gg, Ss, Gg, Ss^Vhs, Gg
Mm, Mm, Hhd, Hhd, Uh, Hhd, Hhd, Rd, Gd, Uh, Uh, Gs, Hhd, Md, Md, Mm^Xm, Md, Mm, Gs, Gg, Gg, Gg, Gg, Gg, Gg, Ss, Gg, Gg, Gg, Ss, Ss, Gg, Ww, Ww
Mm, Mm, Uh, Uh, Rd^Dr, Uh, Rd, Uh, Rd^Vhr, Rd, Rd, Rd, Uh, Rd, Rd^Es, Hhd, Hhd, Hhd, Gs, Gg, Gs, Ce, Ce, Gg, Gg, Gg, Gg, Gg, Gg, Ss, Gg, Gg, Sm, Ss
Mm, Hhd, Uh, Uh, Rd^Es, Uh, Rd, Uh, Uh, Gd, Uh, Uh, Md, Uh, Rd, Rd, Gs, Gs, Gs, Gs, Gg, Ce, Ke, Ce, Gg, Gg, Gs, Gg, Gg, Gg, Gg, Ss, Ss, Ss
Hhd, Hhd, Uh, Rd, Gd, Uh, Gs, Gd, Uh, Rd^Dr, Uh, Gs, Uh, Uh, Uh, Uh, Uh, Rd, Gs, Gs, Gs, Gg, Gs, Ce, Gs, Gg, Gg, Gg, Gg, Gg, Gg, Ss, Gg^Efm, Ww
Mm, Hhd, Rd, Uh, Uh, Uh, Gs, Rd, Rd, Uh, Hh, Rd, Gg, Uh, Gg, Rd, Gs, Rd, Uh, Gs, Gg, Gs, Gg, Gg, Gg, Gs, Gg, Gg, Gg, Gg, Gg, Ss, Gg, Ss
