border_size=1
usage=map

Wog, Wog, Wog, Wo, Ww, Ds, Ww, Wo, Ww, Gg, Gs^Vc, Re, Gs, Gs, Gd, Hhd, Gd, Hhd, Hhd, Gd, Gd, Gd, Gd, Gd, Gd, Gd, Gs, Md, Hh, Hh, Mm^Xm, Md^Xm, Md^Xm, Md, Mm^Xm, Mm, Hhd, Rd, Rd, Hhd, Hhd, Mm, Hhd, Md, Gd, Hhd, Rd, Rd, Gd^Dr, Md^Xm, Mm, Mm, Md^Xm, Mm, Mm, Hhd, Mm, Hh, Hh, Re, Gg, Re
Wog, Wog, Wo, Wo, Wo, Ww, Ww, Ww, Gs, Ww, Gs, Re, Gd, Gd, Gd, Gd, Gd, Gs, Hhd, Gd, Hhd, Hhd, Md, Gd, Gs, Md, Hh, Hh, Mm, Mm^Xm, Mm^Xm, Mm^Xm, Mm, Md^Xm, Mm^Xm, Hhd, Hhd, Gd, Gd, Rd, Rd, Md, Md^Xm, Hhd, Hhd, Rd, Hhd, Md, Md, Md, Mm, Hhd, Wog, Mm, Mm, Mm, Md, Mm, Gg^Emf, Gg, Rb^Gvs, Re
Wog, Wog, Wo, Wo, Wo, Wo, Wo, Gs, Ww, Ww, Gs, Rd, Gd, Gd, Gd, Gd, Hhd, Gd, Gd, Gd, Gd, Md, Md, Gs, Md, Mm^Xm, Hh^Vhh, Mm, Mm, Mm, Mm, Mm^Xm, Mm^Xm, Mm, Md, Mm^Xm, Mm, Gd, Hhd, Hhd, Rd, Gd, Hhd, Gd, Rd, Rd, Hhd, Hhd, Hhd, Md, Md^Xm, Md^Xm, Ms^Xm, Mm, Mm, Hh, Hh, Hh, Mm, Hh^Vhh, Rb^Gvs, Re
Wo, Wog, Wog, Wo, Wo, Wo, Wo, Ww, Ww, Wo, Gs, Re, Gs, Gd, Gd^Es, Gd, Gd, Gd, Gd, Hhd, Md, Md, Md, Hh, Mm^Xm, Gg^Em, Gs, Mm, Mm, Mm, Mm^Xm, Mm, Mm, Mm, Mm, Mm^Xm, Mm^Xm, Mm, Mm, Gd, Gd, Rd, Rd, Rd, Hhd, Gd, Hhd, Hhd, Gd, Md, Md^Xm, Mm, Mm, Mm, Mm, Mm, Mm, Mm, Gg, Wo, Re, Re
Wog, Wo, Wo, Wo, Wo, Ww, Gg, Gg, Gg, Gg, Gs, Re, Rd, Rd, Hhd, Gd, Gd, Hhd, Md, Gd, Hhd, Md, Md, Mm, Md, Md, Hh, Mm, Mm, Ms^Xm, Mm, Mm^Xm, Qxu, Mm^Xm, Mm^Xm, Qxu, Mm, Mm, Mm, Hhd, Gd, Gd, Hhd, Gd, Gd, Gd, Gd, Hhd, Md, Md^Xm, Mm, Mm, Mm, Hh, Mm, Gg, Gg, Gs, Gs, Gs, Rr, Rr
Wog, Wog, Wo, Wo, Ww, Ww, Gg, Gs, Gs, Gs, Gs, Re, Hhd^Vhhr, Hhd, Md, Hhd, Hhd, Md, Gg, Mm, Mm^Xm, Md, Mm^Xm, Mm, Hh, Hh, Md, Mm, Mm, Mm, Mm, Mm, Mm^Xm, Mm, Mm, Mm^Xm, Mm, Mm, Hhd, Gd, Gd, Gd, Hhd, Gd, Gd, Gd, Hhd, Hhd, Gs, Mm^Xm, Mm^Xm, Mm, Gg, Mm, Mm, Mm, Mm, Gs, Rr, Rr, Re, Re
Wo, Wo, Wo, Wo, Ww, Hh, Gg, Gg, Hh, Gs, Hh, Re, Hh, Mm, Hh, Md, Mm, Md, Mm, Mm, Mm^Xm, Mm, Mm, Mm, Hh, Gg, Hh, Hh, Hh, Hh, Mm, Mm, Ms^Xm, Ms^Xm, Mm, Mm, Mm, Mm, Hhd^Vhhr, Gd^Dr, Gd, Hhd, Hhd, Gd^Es, Hhd, Gd, Gd, Gd, Hhd, Mm, Mm^Xm, Md, Hh, Hh, Gg, Chr, Rp, Rr, Hh, Gs, Gg, Re
Wo, Wo, Ww, Hh, Wo, Mm, Mm, Hh, Gs, Gs, Chr, Re, Mm, Mm, Gg, Hh, Mm, Mm^Xm, Mm, Hh, Mm, Mm, Mm, Hh, Mm, Mm, Mm, Mm, Mm, Mm, Mm^Xm, Qxu, Mm, Ms^Xm, Mm, Mm, Mm, Mm, Hhd, Gs, Hhd, Gd, Gd, Hhd, Hhd, Hhd, Gd, Md, Md^Xm, Md, Mm^Xm, Mm, Hh, Gg, Rp, Rr, Chr, Gg, Gg, Gg, Gg^Efm, Gg
Wo, Wo, Wo, Wo, Wo, Ww, Wo, Hh, Khr, Chr, Chr, Re, Chr, Gg, Gs, Hh, Gg, Mm, Hh, Mm, Mm, Mm, Mm, Mm, Mm, Mm, Mm, Mm, Mm, Mm, Ms^Xm, Mm^Xm, Mm^Xm, Mm, Mm, Mm, Mm, Mm, Gd, Hhd, Gs, Hhd, Gd, Gd, Hhd, Gs, Md, Md^Xm, Gg, Mm^Xm, Hh, Gg, Rp, Rp, Gg, Chr, Chr, Hh, Hh, Hh, Hh, Mm
Wo, Wo, Wo, Wo, Ww, Wo, Wo, Wo, Gs, Chr, Gg, Re, Re, Gg, Gs, Gg, Gs, Hh, Gg, Hh, Gg^Efm, Mm^Xm, Mm^Xm, Mm, Hh, Hh, Mm, Ms^Xm, Mm, Mm, Mm^Xm, Ms^Xm, Mm^Xm, Mm, Mm, Mm, Hhd, Hhd, Gd, Hhd, Gd, Hhd, Hhd, Hhd, Md, Hhd, Mm^Xm, Mm^Xm, Hh, Mm, Gg, Rp, Hh, Gg, Hh, Chr, Hh, Mm, Mm, Mm, Mm, Hh
Wo, Wo, Ww, Wo, Hh, Hh, Gg, Gg, Gg, Gg, Gs, Re, Gs, Re, Re, Gs, Gs, Hh, Gg, Mm, Mm, Mm, Mm^Xm, Hh, Gs, Mm, Wo, Wo, Mm^Xm, Mm^Xm, Ms^Xm, Mm^Xm, Mm, Mm, Mm, Mm, Hhd^Vhhr, Gd, Hhd, Gd, Gd, Gs, Md, Md, Mm^Xm, Wo, Rb^Em, Hh, Gg, Rb, Re, Rp, Rb^Gvs, Gg^Vh, Wwg, Wo, Mm, Mm, Ms^Xm, Ms^Xm, Mm, Mm
Wo, Wo, Gg, Gg, Gg, Gs, Gg, Hh, Gs, Gs, Gs, Re, Hh, Gs, Gs, Re, Re, Gs, Gg, Hh, Hh^Vhh, Wog, Mm^Xm, Hh, Ww, Mm, Wo, Mm, Mm^Xm, Ms^Xm, Mm^Xm, Ms^Xm, Mm, Mm, Mm, Mm, Hhd, Hhd, Gs, Gd^Es, Gd, Hhd, Md, Md^Xm, Hh, Hh, Gg, Gg, Gg, Gg, Gs, Rp, Gg, Rb^Gvs, Wo, Mm^Xm, Mm^Xm, Mm^Xm, Hh, Mm, Ww, Mm
Wo, Ww, Gs, Gs, Gs, Gs, Gg, Gs, Gs, Gs, Gg, Re, Gg, Gg, Gg, Gs, Gs, Re, Rb, Gg, Gg, Rb^Gvs, Wo, Wo, Mm^Xm, Wo, Hh, Mm, Mm, Mm^Xm, Mm, Mm, Mm, Mm, Hhd, Hhd, Hhd, Hhd, Hhd, Gd, Hhd, Md, Md, Mm^Xm, Md, Hh^Vhh, Gs, Gs, Gs, Gs, Gs, Rp, Gs, Mm, Wo, Gg, Ww, Wo, Wo, Ww, Mm, Ww
Wo, Wo, Gs, Gs, Gg, Wo, Ww, Wo, Wo, Gs, Wo, Re, Gs, Gs, Gs^Vc, Gs, Gs, Gg, Gg, Rb, Rb, Hh, Ww, Hh, Mm, Mm, Mm, Mm, Mm, Mm, Hh, Mm, Hh, Mm, Gd, Hhd, Gd, Hhd, Hhd, Gd, Hhd, Md, Gs, Mm^Xm, Hh, Hh, Hh, Gs, Gs, Gs, Gs, Rp, Rp, Gg^Vc, Wo, Wo, Hh, Mm, Hh, Gg, Mm^Xm, Mm^Xm
Wo, Ww, Ww, Gg, Wo, Wo, Wo, Gg^Vc, Wo, Wo, Ww, Wo^Bw|r, Wo, Ds, Wo, Gg, Gg, Gg, Wwf, Ww, Ww, Wwf, Rb, Gg, Gs, Hh, Mm, Mm^Xm, Mm, Hh, Mm, Hh, Hh, Gs, Gd, Gs, Gd^Es, Gd, Gs, Hhd, Hh, Gs, Gs, Hh, Gs, Gg, Gs, Gs, Gs, Rd, Gg, Gg, Wo^Bw|r, Wo, Mm, Mm, Mm, Mm, Mm, Hh, Mm^Xm, Mm
Ww, Wo, Wo, Ww, Ww, Ww, Wo, Wo, Ww, Wo, Wo, Wo, Wo, Wo, Ww, Wo, Wo, Wo, Ww, Gg, Gg, Gg, Gg, Re, Re, Re, Re, Mm^Xm, Md, Hh, Mm, Hh, Hh, Hh, Gd, Gd, Gs, Gs, Hh, Hh, Gg, Gs, Gs, Gg, Gs, Gs, Gs, Hh, Gs, Gs, Wo, Wo, Rp, Chr, Rb, Hh, Re, Mm, Hh, Ms^Xm, Mm, Mm^Xm
Wo, Ww, Wo, Ww, Wo, Wo, Wo, Ww, Wo, Wo, Wo, Ww, Wo, Wo, Wo, Wo, Wo, Wo, Wo, Ww, Ww, Gg, Wwf, Gs, Gg, Gs^Vc, Gs, Re, Re, Hh, Gs, Hh, Gs, Gs, Hh, Gs, Hh, Gs, Gs, Gg, Gs, Gs, Gs, Gs, Gs, Gs, Hh, Gs, Gs, Gs, Wo, Wo, Rp, Gg, Hh, Re, Hh, Re, Re, Re, Re, Mm
Wo, Wo, Ww, Wo, Ww, Ww, Wo, Wo, Wo, Wo, Wo, Wo, Wo, Wo, Wo, Wo, Wo, Wo, Wo, Ww, Ww, Wo, Gg, Gg, Gg, Gg, Gs, Hh, Hh, Re, Re, Hh, Md, Hh, Hh, Gs, Gs, Gs, Gs, Gs, Gs, Gs, Gg, Gs, Gs, Gs, Gs, Gg, Wo, Hh, Wog, Hh^Vhh, Rp, Gg, Gg, Mm, Mm, Hh, Mm, Mm, Mm, Re
Wo, Wo, Wo, Ww, Wo, Wo, Wo, Wo, Wo, Wo, Ww, Wo, Ww, Wo, Wo, Wo, Wo, Wo, Wo, Ww, Wo, Ww, Ww, Wo, Gg, Gg, Gs, Gs, Gs, Gs, Gs, Re, Re, Md, Re, Re, Re, Gs, Gs, Hh, Gs, Gs, Gs, Gs, Hh, Gs, Hh, Gg, Wo, Wog, Mm, Hh, Rp, Hh, Mm, Mm, Mm, Ms^Xm, Mm, Mm, Ms^Xm, Mm
Wo, Wo, Wo, Wo, Ww, Wo, Wo, Wo, Wo, Wo, Wo, Wo, Ss, Ww, Wo, Ww, Ww, Wo, Ww, Wo, Wo, Ww, Wwf, Wwf, Wwf, Gg, Gg, Gg, Gs, Gs, Gs, Gs, Hh, Re, Gs, Gs, Gs, Re, Rb, Gg, Hh, Hh, Gs^Es, Gs, Re, Gs, Re, Hh, Ww, Mm, Mm, Mm, Rp, Mm, Mm, Mm, Ms^Xm, Ms^Xm, Wo, Mm, Mm, Mm
Wo, Wo^Bw\r, Gg, Gg^Vc, Gg, Gg, Wo, Wo, Wo, Ww, Ss, Wo, Wo, Gg, Wo, Wo, Ww, Wo, Wo, Wo, Ww, Ww, Ww, Ww, Wwf, Gg, Gs, Gg, Gs, Gg, Gs, Gs, Gs, Gs^Es, Hh, Hh, Gs, Gs, Gg, Rb, Re, Gs, Re, Re, Gs, Re, Hh, Re, Wwf, Hh, Hh, Gg, Rp, Mm, Mm, Mm, Mm, Wo, Gg^Efm, Ms^Xm, Mm, Mm
Wo, Wo, Gg, Gg, Gg, Wo, Ww, Wo, Wo, Wo, Ww, Gg, Wo, Gg, Wo, Ww, Wo, Wo, Ww^Vm, Wo, Ww, Ww, Ww, Wwf, Gg, Gg, Gg, Gs, Gg, Gs, Gs, Gs, Hh, Gs, Gs, Gs, Ww, Gg, Gg, Gs, Gs, Re, Gs, Gs, Gs, Hh, Ww, Ww, Wo, Re, Re, Gs, Rp, Gs, Mm, Mm, Mm, Ms^Xm, Mm, Mm, Mm, Gg
Wo, Wo, Wo, Wo, Wo, Wwf, Wo, Ww, Gg, Gg, Gg, Gg, Ww, Ww, Gg, Wo, Ww, Wwf, Wo, Wwf, Ww, Ww, Wo, Wo, Ww, Gg, Wo, Gs, Gg, Gs, Gs, Gs, Gs, Gs, Ww, Ww, Ww, Ww, Wo, Hh, Gs, Hh, Gg, Gg, Gg, Mm, Wo, Ww, Hh, Hh, Gs, Re, Rp, Hh, Mm, Mm, Ms^Xm, Ms^Xm, Mm, Mm, Ms^Xm, Mm
Wo, Wo, Wo, Wo, Wo, Ww, Gg, Gg, Gg, Ss, Ss, Ss, Ss, Gg, Ww, Ss, Wo, Gg, Ww, Wwf, Wo, Ww, Ww, Wo, Wo, Wo, Wo, Gs, Gg, Gs, Hh, Gs, Hh, Gs^Vc, Wo, Wo, Wo, Wo, Wo, Gs^Vc, Gs, Gs, Gs, Gs, Gs, Wo, Ww, Hh, Wo, Gs^Vc, Hh, Gs, Rp, Mm, Hh, Mm, Mm, Mm, Mm, Hh, Hh, Mm
Wo, Wo, Wo, Wo, Ww, Wo, Ww, Gg, Ss, Ss, Gg, Ww, Ss, Gg, Ss, Ss, Ww, Gg, Hh, Ww, Ww, Wwf, Ww, Wo, Wo, Wo, Gs, Gg, Gg, Gs, Gs, Gs, Gs, Ww, Wo, Wo, Ww, Wo, Wo, Wo, Wo, Gs, Ww, Ww, Ww, Wo, Ww, Ww, Wo, Ww, Ww, Mm, Gs, Rp, Rp, Hh, Hh, Mm, Hh, Hh, Mm, Hh
Wo, Wo, Wo, Wo, Wo, Ww, Wo, Ww, Wo, Wo, Ww, Gg, Gg, Gg, Ss, Gg, Gg, Hh, Ss, Ww, Ss, Ss^Vhs, Gg, Wo, Wo, Wo, Wo, Gs, Gs, Gg, Gg, Gs, Gs, Gs, Gs^Vh, Ww^Bw|, Gs, Gs, Ww, Ww, Gs, Wo, Ww, Ww, Ww, Wo, Ww, Wo, Wo, Ww, Gs, Gs, Gg, Gg, Gg, Rp, Rp, Rp, Rp, Mm, Rp, Hh
Wo, Ww, Wo, Wo, Wo, Wo, Wo, Wo, Ww, Wo, Wo, Ww, Ww, Ss^Vhs, Gg, Ww, Ss, Ss, Ww, Ww, Ss, Hh, Mm^Xm, Wo, Wo, Wo, Wo, Gs^Vc, Gs, Gs, Gs, Gs, Gs, Sm^Gvs, Sm^Gvs, Gs, Gs, Gs, Ww, Ww, Ww, Wo, Ww, Ww, Gg, Ww, Ww, Wo, Ww, Ww, Gg, Gs, Gs, Gg, Hh, Hh, Gs, Gg, Gg, Rp, Chr, Rp
Wo, Ww, Ww, Wo, Wo, Ww, Ww, Ww, Ww, Wo, Wo, Wo, Ww, Ww, Gg, Ss, Ww, Wo, Hh, Gg, Mm, Hh, Mm, Mm^Xm, Mm^Xm, Hh, Ww, Ww, Ww, Ds, Gs, Gg, Gg, Rb^Gvs, Rb^Gvs, Gg, Gs, Gg, Gg, Gg, Ds, Ds, Gs, Wo, Ww, Gg, Gs, Ww, Gg, Gg, Gg, Gg, Gg, Gg, Gs, Gs, Hh, Gg, Hh, Hh, Mm, Hh
Wo, Wo, Ww, Wo, Wo, Wo, Wo, Wo, Ww, Wo, Wwf, Wo, Ww, Gg, Ww, Gg, Ww, Ww, Gg^Vc, Mm, Hh, Hh, Hh, Mm, Ms^Xm, Hh, Wo, Wo, Wo, Ds, Gs, Gg, Gs, Rb^Gvs, Gs, Gs, Gs, Gs, Gg, Gg, Ww, Ww, Gg, Wo, Ww, Wo, Gg, Ww, Ww, Gg, Gg, Gs, Hh, Mm, Mm, Mm, Hh, Mm, Mm^Xm, Mm, Mm, Mm
Wo, Wo, Ww, Wo, Wo, Wo, Wo, Wo, Wo^Bw\r, Wo, Gg, Ww, Gg, Ss, Wwf, Gg, Ss, Ww, Wo, Gg, Ss, Hh, Hh, Ms, Mm^Xm, Mm, Wo, Wo, Ww, Gg, Gg, Gg, Gg, Gg, Gg, Gg, Ds, Gs, Gg, Gg^Vc, Ww, Wo, Wo, Gg, Wo, Ww, Wo, Wo, Wo, Gg, Gg, Gs, Gs, Mm, Mm, Mm, Mm, Mm^Xm, Mm, Mm, Mm, Mm
Ww, Wo, Wo, Wo, Wo, Wo, Ww, Wo, Ww, Gg, Gg^Vc, Ww, Gg, Ww, Gg, Ww, Gg, Gg, Ss, Wo, Ww, Wo, Ww, Wo, Mm, Mm^Xm, Mm^Xm, Wo, Wo, Gg, Ds, Gg, Gg, Gg, Gs, Gs, Wo, Ds, Wo, Wo, Ww, Wo, Wo, Wo, Wo, Wo, Wo, Ww, Wo, Ww, Wo, Ds, Gg^Vh, Gg, Hh, Sm, Mm, Mm, Mm, Mm^Xm, Mm, Gg
Gg, Wo, Wo, Wo, Ww, Wo, Wo, Ww, Gg, Gg, Gg, Gg, Gg, Wwf, Ww, Gg, Gg, Gg, Gg, Wo, Ww, Ss, Hh, Hh, Mm, Mm, Mm^Xm, Wo, Wo, Wo, Wo, Wo, Wo, Wo, Wo, Wo, Wo, Wo, Wo, Wo, Wo, Wo, Wo, Wo, Wo, Wo, Wo, Wo, Wo, Wo, Wo, Wo, Wo, Wo, Wog, Wo, Wog, Mm, Ww, Mm^Xm, Wo, Wo
Wo, Ww, Wo, Ww, Wo, Ww, Ww, Gg, Gg, Gg, Gg, Gg, Gg, Gg, Gg, Gg, Gg, Gg, Ss, Ww, Ww, Ss, Mm, Hh, Mm^Xm, Mm^Xm, Hh, Ww, Wo, Hh, Gg, Wo, Gg, Wo, Wo, Wo, Gg, Wo, Wo, Wo, Wo, Wo, Wo, Ww, Ww, Ww, Wo, Wo, Wo, Wo, Wo, Wo, Wo, Wo, Wo, Wog, Wog, Wog, Wog, Mm^Xm, Wog, Wog
Wo, Ww, Ww, Wo, Ww, Wo, Ww, Gg, Gg, Gg, Gs, Gg, Gg, Gg, Gg, Gg, Hh, Gg, Hh, Hh, Ww, Gg, Hh, Hh^Vhh, Mm^Xm, Mm, Wo, Wo, Wo, Wo, Ds, Gg, Wo, Wo, Gs, Wo, Gg^Vc, Wo, Wo, Ww, Wo, Ww, Ww, Wo, Ww, Wo, Wo, Wo, Ww, Wo, Wo, Wo, Wo, Wo, Wo, Mm, Mm, Wog, Wog, Wog, Wog, Wog
Wo, Wo, Wo, Gg, Gg, Wo, Gg, Gg, Ce, Gg, Gs, Gg, Gs, Gg, Gg, Gg, Mm, Mm, Mm, Mm, Wo, Hh, Mm, Mm^Xm, Mm, Mm^Xm, Mm^Xm, Wo, Wo, Wo, Hh, Gg, Gg, Gg, Gg, Gs, Gg, Wo, Wo, Wo, Wo, Wo, Wo, Wo, Wo, Wo, Ww, Gg, Gg, Ww, Ss, Gg, Gg, Gg^Vc, Wo, Mm, Hh, Sm, Mm, Wog, Mm, Gg
Ww, Ww, Ww, Gg^Vc, Gg, Gg, Gg, Ce, Ke, Ce, Gg, Gg, Gg, Gg, Hh, Gg, Gg, Mm^Xm, Mm^Xm, Mm^Xm, Ms^Xm, Wo, Hh, Mm^Xm, Wo, Ms^Xm, Ms^Xm, Gg, Wo, Wo, Wo, Wo, Wo, Gg, Wo, Gg, Wo, Wo, Ww, Ww, Wo, Wo, Wo, Wo, Gg, Ss, Sm, Gg, Ww, Ww, Ww, Ss, Gg, Ss, Gg, Mm, Mm, Mm, Gg, Mm^Xm, Mm^Xm, Mm
Wo, Ww, Ww, Ww, Gs, Gg, Gs, Gg, Gg, Ce, Gs, Gs, Gg, Gg, Gs, Hh, Hh, Gg, Hh, Hh, Ha^Vhha, Ww, Wo, Wo, Ms, Ha, Mm^Xm, Wo, Ww, Ww, Wo, Wo, Wo, Wo, Wo, Wo, Wo, Wo, Wo, Ww, Wo, Ww, Ww, Gg, Ss, Ss, Wo, Ss, Ss, Ss, Sm, Ss, Ss, Gg, Hh, Mm, Mm, Mm, Mm, Mm, Mm^Xm, Mm
Ww, Wo, Gs, Gg, Gg, Gs, Gs, Gg, Gg, Gg, Gg, Gs, Mm, Hh, Mm, Mm, Mm^Xm, Mm, Hh, Mm, Hh, Mm^Xm, Mm, Wo, Wo, Wo, Mm^Xm, Wo, Wo, Wo, Wo, Wo, Hh, Gg, Gg, Wo, Wo, Wo, Wo, Wo, Ss, Ww, Gg, Wo, Ss, Ss, Ss, Ww, Chs, Ww, Gg, Ss, Gg, Ss, Gg, Mm, Mm, Mm, Mm^Xm, Mm, Mm^Xm, Mm^Xm
Gg, Gs, Gs, Gs, Gs, Gg, Gs, Gs, Hh, Hh, Gs, Mm, Hh, Mm, Mm, Mm, Mm^Xm, Mm^Xm, Mm^Xm, Mm^Xm, Hh, Mm, Mm^Xm, Mm^Xm, Ww, Mm^Xm, Mm^Xm, Wo, Wo, Wo, Wo, Hh, Gg, Gg, Ss^Vhs, Wo, Ss, Ss, Ww, Ss, Ss, Ds, Ss, Ww, Ss, Ww, Ss, Chs, Chs, Khs, Ss, Gg, Ss, Gg, Hh, Hh, Mm, Mm^Xm, Ms^Xm, Mm^Xm, Mm, Mm
Gg, Gs, Gg, Gs, Gg, Gg, Gs, Gs, Hh, Hh, Hh, Mm, Hh, Mm, Hh, Hh, Mm^Xm, Mm, Hh, Hh, Gg, Gs, Hh, Mm^Xm, Mm^Xm, Mm^Xm, Hh, Wo, Hh, Hh, Wo, Hh, Gg, Ss, Ss, Ss, Ww, Ss, Ww, Ss, Ww, Ww, Ss, Ss, Ss, Ww, Ss, Ss, Ss, Chs, Ww, Ww, Ww, Mm, Hh, Mm, Mm, Mm^Xm, Mm, Ms^Xm, Ms, Mm
Gg, Gg, Gs, Gg, Gs, Gs, Hh, Hh, Hh, Mm, Mm, Mm, Gg, Hh, Gg, Gs, Mm, Hh, Mm, Mm, Gs, Gs, Hh, Mm^Xm, Mm^Xm, Mm, Hh, Mm, Hh, Wo, Hh, Gg, Gg, Gg, Ss, Ww, Gg, Ss, Ss, Gg, Ss, Ss, Ss, Sm, Ww, Ss, Ss, Ss, Ss, Ss, Ss, Gg, Ww, Hh, Hh, Mm, Ms^Xm, Ms^Xm, Mm, Ms^Xm, Wo, Mm
Gs^Vc, Gs, Gs, Gs, Gs, Gs, Hh, Mm, Mm, Mm, Mm, Hh, Mm, Gg, Hh, Gs, Mm, Mm, Mm, Hh, Gg, Hh, Mm, Mm^Xm, Hh, Mm, Mm, Hh, Mm, Hh, Gs, Gg, Gg, Ss, Gg, Ss, Ss, Gg, Sm, Ww, Ss, Ss, Ss, Ss, Ss, Ss, Wo, Ss, Ss, Ww, Ss, Ss, Sm, Mm, Mm, Mm, Mm, Mm, Mm^Xm, Ms^Xm, Mm, Wo
Ww, Gg, Gg, Gs, Gg, Hh, Hh, Mm, Mm, Mm^Xm, Mm^Xm, Hh, Hh, Hh, Mm, Mm, Mm, Hh, Gg, Gg, Mm, Mm, Mm^Xm, Mm^Xm, Mm^Xm, Mm, Mm, Mm, Hh, Gs, Gg, Gg, Gg, Gg, Gg, Gg, Gg, Gg, Ss, Ss, Ss, Ss, Ss, Gg, Ss, Ss, Ss, Ss, Sm, Ss, Ss, Ss, Gg, Ss, Mm, Mm, Wo, Mm, Mm^Xm, Mm, Mm, Mm
Ww, Gg, Gg, Gg, Hh, Hh, Mm, Mm^Xm, Mm^Xm, Mm^Xm, Mm^Xm, Mm, Mm, Mm, Mm, Mm, Hh, Gg, Hh, Mm^Xm, Mm^Xm, Mm^Xm, Mv, Md^Xm, Mm^Xm, Hh, Mm^Xm, Hh, Mm, Gs, Hh, Hh, Mm, Gg, Gg, Gg, Gg, Ss, Wo, Ss, Wo, Ww, Ss, Ss, Ss, Ww, Gg, Ww, Ss, Ww, Ss^Vhs, Ss, Ww, Hh, Wo, Wo, Mm, Mm^Xm, Ms^Xm, Mm, Mm, Mm
Gg, Gg, Hh, Hh, Mm, Mm, Mm^Xm, Mm^Xm, Ms^Xm, Mm^Xm, Mm^Xm, Mm, Ms, Mm, Hh^Vhh, Mm, Mm, Hh, Hh, Mm, Md^Xm, Mm, Uh, Uh, Hhd, Mm^Xm, Md, Mm^Xm, Hh, Gs, Mm^Xm, Mm, Mm^Xm, Hh, Gg, Ss, Gg, Gg, Ss, Ss, Ss, Ss, Gg, Ss, Ss, Ss, Ww, Ww, Ss, Ss, Ww, Ss, Gg, Ww, Hh, Gg, Hh, Mm, Mm, Ms^Xm, Mm^Xm, Mm^Xm
Gs, Gg, Hh, Mm, Mm, Mm^Xm, Ms^Xm, Ms^Xm, Mm^Xm, Mm^Xm, Mm^Xm, Mm, Mm, Wo, Rb^Emf, Rb^Gvs, Gg, Hh, Gg, Mm, Md^Xm, Md^Xm, Md, Uh, Uh, Uh, Rd^Vhr, Mm^Xm, Mm^Xm, Mm^Xm, Md, Mm^Xm, Wo, Mm, Gg, Gg, Gg, Ss, Gg, Gg, Gg, Gg, Gg, Gg, Ww, Ss, Ss, Ss, Ss, Gg, Ss, Ss, Wo, Mm, Hh, Hh, Mm, Mm, Ms^Xm, Ms^Xm, Mm, Mm^Xm
Gg, Hh, Mm, Hh, Mm^Xm, Ms^Xm, Mm^Xm, Mm^Xm, Mm^Xm, Mm^Xm, Mm^Xm, Mm, Gg, Mm, Hh, Rb^Gvs, Hh, Hh, Hh, Hh, Md^Xm, Md^Xm, Hhd, Uh, Uh, Rd, Uh, Hhd, Hhd, Md, Md, Mm^Xm, Mm^Xm, Hh^Vhh, Mm, Gs, Gg, Gg, Gg, Gg, Gg, Gg, Ss, Gg, Ss, Ss, Ss, Ss, Gg, Ss, Gg, Gg, Gg, Ww, Ww, Wo, Wo, Ms, Mm, Mm, Mm^Xm, Mm^Xm
Hh, Hh, Mm, Mm, Mm^Xm, Mm^Xm, Mm, Mm, Mm^Xm, Mm^Xm, Mm^Xm, Hh, Hh, Mm, Mm, Hh, Mm, Mm, Mm^Xm, Mm^Xm, Rd^Vhr, Hhd, Rd^Es, Uh, Uh, Rd, Uh, Uh, Rd^Dr, Hhd, Hhd, Rd^Vhr, Mm^Xm, Mm^Xm, Mm^Xm, Hh, Hh, Gg, Gg, Ss, Gg, Gg, Gg, Gg, Ss, Gg, Gg, Gg, Ss, Gg, Gg, Gg, Ww, Ww, Sm, Hh, Mm, Mm, Mm^Xm, Mm, Mm^Xm, Mm
Hh, Mm, Mm, Mm, Mm, Mm, Hh, Mm, Mm, Mm, Mm^Xm, Mm, Mm, Mm^Xm, Mm^Xm, Mm^Xm, Mm^Xm, Mm^Xm, Mm, Mm, Hhd, Hhd, Uh, Hhd, Hhd, Rd, Gd, Uh, Uh, Gs, Hhd, Md, Md, Mm^Xm, Md, Mm, Gs, Gg, Gg, Gg, Gg, Gg, Gg, Ss, Gg, Gg, Gg, Ss, Ss, Gg, Ww, Ww, Hh, Wo, Hh, Hh, Mm, Ms^Xm, Mm, Mm^Xm, Mm, Mm
Hh, Hh, Mm, Mm^Xm, Mm^Xm, Hh, Gg, Hh, Mm, Mm^Xm, Wog, Mm^Xm, Mm, Mm^Xm, Mm, Mm, Mm^Xm, Mm, Mm, Mm, Uh, Uh, Rd^Dr, Uh, Rd, Uh, Rd^Vhr, Rd, Rd, Rd, Uh, Rd, Rd^Es, Hhd, Hhd, Hhd, Gs, Gg, Gs, Ce, Ce, Gg, Gg, Gg, Gg, Gg, Gg, Ss, Gg, Gg, Sm, Ss, Ww, Ww, Mm, Mm, Mm^Xm, Mm^Xm, Mm, Mm, Mm, Mm
Mm, Mm, Mm, Mm, Hh, Hh, Gg, Mm, Mm^Xm, Mm^Xm, Mm, Gg, Mm^Xm, Mm, Mm, Mm^Xm, Mm^Xm, Mm^Xm, Mm, Hhd, Uh, Uh, Rd^Es, Uh, Rd, Uh, Uh, Gd, Uh, Uh, Md, Uh, Rd, Rd, Gs, Gs, Gs, Gs, Gg, Ce, Ke, Ce, Gg, Gg, Gs, Gg, Gg, Gg, Gg, Ss, Ss, Ss, Ww, Mm, Mm, Mm, Mm^Xm, Mm, Mm^Xm, Mm, Mm, Mm
Rd, Mm, Wog, Mm^Xm, Hh, Gg, Gg, Mm, Mm^Xm, Mm^Xm, Mm, Mm, Rd, Mm^Xm, Mm, Mm^Xm, Mm^Xm, Mm^Xm, Hhd, Hhd, Uh, Rd, Gd, Uh, Gs, Gd, Uh, Rd^Dr, Uh, Gs, Uh, Uh, Uh, Uh, Uh, Rd, Gs, Gs, Gs, Gg, Gs, Ce, Gs, Gg, Gg, Gg, Gg, Gg, Gg, Ss, Gg^Efm, Ww, Gg, Mm, Gg, Mm, Mm^Xm, Mm, Mm^Xm, Hh, Hh, Mm
