border_size=1
usage=map

Rb, Gg, Gg, Rb^Gvs, Wo, Wo, Mm^Xm, Wo, Hh, Mm, Mm, Mm^Xm, Mm, Mm, Mm, Mm, Hhd, Hhd
Gg, Rb, Rb, Hh, Ww, Hh, Mm, Mm, Mm, Mm, Mm, Mm, Hh, Mm, Hh, Mm, Gd, Hhd
Wwf, Ww, Ww, Wwf, Rb, Gg, Gs, Hh, Mm, Mm^Xm, Mm, Hh, Mm, Hh, Hh, Gs, Gd, Gs
Ww, Gg, Gg, Gg, Gg, Re, Re, Re, Re, Mm^Xm, Md, Hh, Mm, Hh, Hh, Hh, Gd, Gd
Wo, Ww, Ww, Gg, Wwf, Gs, Gg, Gs^Vc, Gs, Re, Re, Hh, Gs, Hh, Gs, Gs, Hh, Gs
Wo, Ww, Ww, Wo, Gg, Gg, Gg, Gg, Gs, Hh, Hh, Re, Re, Hh, Md, Hh, Hh, Gs
Wo, Ww, Wo, Ww, Ww, Wo, Gg, Gg, Gs, Gs, Gs, Gs, Gs, Re, Re, Md, Re, Re
Ww, Wo, Wo, Ww, Wwf, Wwf, Wwf, Gg, Gg, Gg, Gs, Gs, Gs, Gs, Hh, Re, Gs, Gs
Wo, Wo, Ww, Ww, Ww, Ww, Wwf, Gg, Gs, Gg, Gs, Gg, Ke, Gs, Gs, Gs^Es, Hh, Hh
Ww^Vm, Wo, Ww, Ww, Ww, Wwf, Gg, Gg, Gg, Gs, Gg, Ce, Ce, Ce, Hh, Gs, Gs, Gs
Wo, Wwf, Ww, Ww, Wo, Wo, Ww, Gg, Wo, Gs, Gg, Ce, Ke, Ce, Gs, Gs, Ww, Ww
Ww, Wwf, Wo, Ww, Ww, Wo, Wo, Wo, Wo, Gs^Ecf, Gg, Ce, Hh, Gs, Hh, Gs^Vc, Wo, Wo
Hh, Ww, Ww, Wwf, Ww, Wo, Wo, Wo, Gs, Gg, Gg, Gs, Gs, Gs, Gs, Ww, Wo, Wo
Ss, Ww, Ss, Ss^Vhs, Gg, Wo, Wo, Wo, Wo, Gs, Gs, Gg, Gg, Gs, Gs, Gs, Gs^Vh, Ww^Bw|
Ww, Ww, Ss, Hh, Mm^Xm, Wo, Wo, Wo, Wo, Gs^Vc, Gs, Gs, Gs, Gs, Gs, Sm^Gvs, Sm^Gvs, Gs
Hh, Gg, Mm, Hh, Mm, Mm^Xm, Mm^Xm, Hh, Ww, Ww, Ww, Ds, Gs, Gg, Gg, Rb^Gvs, Rb^Gvs, Gg
