border_size=1
usage=map

Ww, Wo, Ww, Gs, Gs, Re, Gs, Gs, Hh, Md, Hhd, Hh, Mm, Wo, Wo, Hh, Md, Hhd, Hhd, Md, Md, Md, Hhd, Md, Md, Hhd, Gd, Rd, Hhd, Hhd, Hhd, Hhd, Rd, Rd, Hhd, Gd, Md, Gd, Mm, Mm, Wo, Re, Md, Gg, Md, Md, Hhd, Hhd, Hhd, Hhd, Md, Gd, Md, Hhd, Hhd
Wo, Wo, Wo, Gs, Gs, Re, Re, Gs, Gd, Hhd, Gd, Hhd, Hhd, Mm, Wo, Mm, Ms^Xm, Md, Md, Hhd, Re, Md, Rd, Md, Rd, Md, Hhd, Md, Hhd, Gd, Rd, Rd, Hhd, Hhd, Md, Md, Md, Md, Mm, Wo, Gs^Vc, Re, Md, Md, Hhd, Md, Md, Md, Md, Md, Md, Md, Md, Hhd, Hhd
Ww, Ww, Ww, Ww, Ww, Gs, Hh, Re, Hhd, Hhd, Md, Hhd, Hhd, Mm, Mm, Ww, Mm, Ww, Hh^Vhh, Gs, Md, Rd, Md, Rd, Hhd, Rd, Rd, Hhd, Rd, Rd, Gd^Vhr, Hhd, Gd, Md, Md, Hhd, Md, Md^Xm, Mm, Wo, Wwf, Re, Md, Md, Hhd, Md, Md, Md, Md, Md, Md, Hhd, Md, Hhd, Hhd
Ww, Ww, Wo, Ww, Ww, Gs, Gs^Vc, Re, Hhd, Md, Hhd, Gd, Hhd, Hhd, Mm, Wo, Ww, Wo, Mm, Md, Hhd, Gd, Gd, Md, Hhd, Gd, Md, Rd, Rd, Hhd, Hhd, Gd^Edb, Md, Md, Hhd, Hhd, Md, Md^Xm, Wo, Wo, Mm, Re, Rd, Md, Hhd, Md, Md, Md, Hhd, Md, Hhd, Md, Hhd, Md, Hhd
Ww, Wo, Wo, Gs, Ww, Wo, Gs, Re, Gd, Gd, Hhd, Md, Md, Hhd, Md, Mm, Mm, Mm, Gd, Gd, Hhd, Hhd, Hhd, Md, Md, Md, Gd, Hhd, Rd, Hhd, Hhd, Hhd, Md, Md, Md, Md, Md^Xm, Wog, Mm, Mm, Md, Md, Gd, Rd, Rd, Md, Md, Hhd, Md, Md, Md, Hhd, Md, Md, Md
Wo, Ww, Wo, Gs, Ds, Gg, Gs, Re, Hhd, Gd, Hhd, Gd, Md, Gd, Hhd, Gd, Hhd, Md, Hhd, Hhd, Gd, Md, Hhd, Gd, Gd, Hhd, Rd, Rd, Gd, Md, Md, Md, Md^Xm, Hhd, Hhd, Md^Xm, Md, Mm, Md, Gd, Md, Md, Hhd, Md, Rd, Gd, Md, Md, Md, Hhd, Md, Hhd, Md, Md, Gd
Wo, Wo, Gg, Gs, Gs, Gs, Gd, Re, Gd, Gd, Gd, Md, Md, Hhd, Gd, Hhd, Gd, Hhd, Hhd, Hhd, Gd, Gd, Hhd, Gd, Gd, Rd, Md, Hhd, Gd, Hhd, Md, Md, Md^Xm, Gd, Hhd, Md^Xm, Md^Xm, Md, Md, Gd, Md, Hhd, Md, Md, Rd, Md, Gd^Vhr, Gd, Hhd, Md, Md, Md, Hhd, Md, Gd
Wo, Wo, Gg, Gg, Gd, Gd, Gs, Rd, Gd, Hhd, Hhd, Hhd, Hhd, Gd, Hhd, Gd, Hhd, Gd, Gd, Hhd, Gd, Hhd, Md, Md, Hhd, Rd, Md, Hhd, Hhd, Md, Md, Md^Xm, Mv, Md^Xm, Hhd, Hhd, Md^Xm, Md, Md, Md, Hhd, Hhd, Gd, Rd, Hhd, Hhd, Md, Gd^Edb, Hhd, Hhd, Md, Hhd, Md, Md, Hhd
Wo, Gg, Gs, Gs, Gs, Gd, Hhd, Rd, Gd, Gd, Hhd, Hhd, Gd, Hhd, Gd, Gd, Hhd, Gd, Gd, Gd, Hhd, Gd, Hhd, Gd, Rd, Rd, Gd^Vhr, Md^Xm, Md, Md, Md^Xm, Md^Xm, Hhd, Md^Xm, Md^Xm, Md^Xm, Md, Md, Md, Hhd, Md, Gd, Hhd, Rd, Hhd, Hhd, Gd, Md, Md, Md, Md, Hhd, Hhd, Md, Hhd
Wo, Wo, Gs, Gg, Gg, Gd, Gd, Rd, Rd, Gd, Gd, Gd, Hhd, Gd, Gd, Hhd, Gd^Vhr, Hhd, Gd, Gd, Gd, Gd, Gd, Rd, Hhd, Gd, Hhd, Md, Md^Xm, Md^Xm, Md, Md, Md, Hhd, Md, Md, Md, Md, Md, Gd, Gd, Hhd, Rd, Rd, Hhd, Hhd, Hhd, Md^Xm, Md^Xm, Md, Hhd, Md^Xm, Md^Xm, Md, Md
Wo, Wo, Ww, Gg, Gg, Gs, Gs, Gd, Rd, Hhd, Gd, Hhd, Hhd, Md, Md, Mm, Gd, Gd, Gd^Es, Gd, Hhd, Gd, Rd, Rd, Hhd, Md^Xm, Gd, Md^Xm, Md^Xm, Md, Md, Md, Md, Gd, Md, Md, Md, Md, Md, Gd, Rd, Rd, Gd, Hhd, Gd, Gd, Hhd, Md, Md, Md^Xm, Hhd, Hhd, Hhd, Md^Xm, Md
Gg, Ww, Wo, Ww, Wo, Gs, Gg, Gs, Re, Gd, Gd, Hhd, Hhd, Gd, Hhd, Hhd, Gd, Gd, Gd, Gd, Gd, Gd, Rd, Gd, Gd, Hhd, Gd, Md^Xm, Hhd, Md^Xm, Hhd, Md, Md, Md, Md, Md, Gd^Es, Md, Hhd, Hhd, Rd, Gd, Hhd, Gd, Gd, Md, Md^Xm, Md, Md, Md, Md^Xm, Md, Gd, Md, Hhd
Wo, Wo, Gs, Wo, Ww, Ww, Ww, Wo, Re, Gd, Gd, Rd, Hhd, Hhd, Md, Gd, Hhd, Hhd, Gd, Hhd, Gd, Gd, Rd, Md, Hhd, Md, Md^Xm, Md^Xm, Hhd, Md^Xm, Md, Md, Md, Hhd, Hhd, Md, Hhd, Gd, Hhd, Gd, Rd, Hhd, Gd, Gd, Gd, Gd, Md, Gd, Md^Xm, Md, Md, Hhd, Md^Xm, Hhd, Md
Wo, Wo, Ww, Gg, Wo, Wo, Gs^Vc, Gg, Re, Gd, Hhd, Gd^Es, Md, Hhd, Hhd, Gd, Hhd, Gd, Hhd, Gd, Gd, Hhd, Rd, Hhd, Hhd, Md^Xm, Md^Xm, Md^Xm, Md^Xm, Md^Xm, Hhd, Md, Md, Md, Md, Gd^Edb, Md, Hhd, Gd, Gd, Rd, Gd, Hhd, Hhd, Gd, Hhd, Gd, Md, Md^Xm, Md, Md, Md, Md, Md, Md
Wo, Ww, Ww, Ww, Wo, Gs, Gd, Gs, Rd, Gd, Gd, Gd, Md, Gd, Hhd, Md, Md, Gd, Hhd, Gd, Rd, Rd, Hhd, Gd^Vhr, Gd, Md, Md^Xm, Md^Xm, Md, Md, Hhd, Md, Gd, Md, Hhd, Hhd, Gd, Gd, Rd, Rd, Gd, Gd^Vhr, Gd, Gd, Gd, Md, Md, Md, Md, Md, Gd, Md, Hhd, Md, Md^Xm
Wo, Gs, Wo, Gs, Gs, Gd, Gd, Gd, Rd, Hhd, Hhd, Hhd, Hhd, Gd, Md, Gd, Gd, Gd, Rd, Rd, Gd, Gd, Hhd, Gd, Hhd, Md, Md^Xm, Md^Xm, Md, Md^Xm, Md, Hhd, Gd^Es, Hhd, Hhd, Hhd, Rd, Rd, Gd, Gd, Gd, Hhd, Hhd, Gd, Gd, Hhd, Hhd, Md^Xm, Md, Md, Md, Md^Xm, Hhd, Md^Xm, Md
Ww, Gg, Gg, Wo, Gs, Gd, Gd, Gd, Rd, Gd, Hhd, Md, Md, Hhd, Gd, Hhd, Rd, Rd, Gd, Gd, Gd, Gd, Gd^Es, Hhd, Gd, Gs, Md, Md^Xm, Md^Xm, Hhd, Hhd, Gd, Hhd, Gd, Hhd, Rd, Gd, Hhd, Gd, Hhd, Gd, Gd, Hhd, Gd, Gd^Edb, Gd, Gd, Gd, Hhd, Hhd, Hhd, Md, Md, Hhd, Gd
Wo, Wo, Wo, Gg, Ww, Gs, Gd, Gd, Rd, Gd, Hhd, Gd, Gd, Hhd, Rd, Rd, Gd, Gd, Gd, Gd, Hhd, Gd, Gd, Gd, Gd, Hhd, Hhd, Md, Hhd, Md^Xm, Hhd, Hhd, Hhd, Gd, Gd, Rd, Hhd, Gd, Md, Hhd, Gd, Hhd, Gd, Gd, Gd, Gd, Hhd, Hhd, Gd, Md, Gd, Md, Hhd^Vhhr, Gd, Rd
Wo, Wo, Ww, Ww, Wo, Gg, Gs, Gs, Gd, Rd, Rd, Hhd, Rd, Rd, Gd, Gd, Hhd, Gd, Gd, Gd, Hhd, Gd, Gd, Hhd, Gd, Md, Hhd, Md, Hhd, Md^Xm, Md, Hhd, Hhd, Gd, Hhd, Rd, Hhd, Md, Hhd, Gd, Gd, Gd, Gd, Hhd, Gd, Gd, Hhd, Md, Hhd, Md, Md, Gd, Rd, Rd, Md
Wo, Wo, Wo, Gg^Vc, Gg, Ww, Gs, Gs, Gs, Gd, Gd, Rd, Hhd, Gd^Vhr, Gd, Gd, Gd, Gd, Gs, Gd, Gd, Gd, Gd, Gd, Hhd, Md, Md, Gg^Efm, Md, Md^Xm, Md^Xm, Md, Hhd, Gd, Gd, Rd, Gd, Gd, Hhd, Gd, Gd, Hhd, Hhd, Gd, Hhd, Gd, Gd, Gd, Gd, Hhd, Rd, Rd, Gd, Gd, Hhd
Wog, Wo, Wo, Wo, Wo, Gs, Gg, Gs, Gs, Gs, Gd, Rd, Gs, Hhd, Gd, Gd^Es, Gd, Hhd, Gd, Gd, Hhd, Hhd, Gd, Gd, Hhd, Hhd, Md, Md, Md, Hhd, Md^Xm, Md, Md, Hhd, Hhd^Vhhr, Rd, Gd, Gd, Gd, Gd, Md, Md, Md, Gd, Gd, Gd, Gd, Gd, Rd, Rd, Hhd, Gd^Es, Md^Xm, Hhd, Gd
Wog, Wog, Wo, Wo, Wo, Gs, Ww, Gg, Ww, Gs, Gs, Rd, Gd, Hhd, Gd, Gd, Gd, Gd, Gd, Gd, Gd^Es, Gd, Hhd, Gd, Gd, Gd^Dr, Hhd, Md, Mm, Mm, Mm, Md^Xm, Md, Hhd, Hhd, Rd, Rd, Gd, Gd, Hhd, Gd, Gd, Md, Md, Gd, Gd, Hhd, Gd, Rd, Md, Md, Hhd, Hhd, Hhd, Hhd
Wog, Wog, Wog, Wo, Ww, Ds, Ww, Wo, Ww, Gg, Gs^Vc, Re, Gs, Gs, Gd, Hhd, Gd, Hhd, Hhd, Gd, Gd, Gd, Gd, Gd, Gd, Gd, Gs, Md, Hh, Hh, Mm^Xm, Md^Xm, Md^Xm, Md, Mm^Xm, Mm, Hhd, Rd, Rd, Hhd, Hhd, Mm, Hhd, Md, Gd, Hhd, Rd, Rd, Gd^Dr, Md^Xm, Mm, Mm, Md^Xm, Mm, Mm
Wog, Wog, Wo, Wo, Wo, Ww, Ww, Ww, Gs, Ww, Gs, Re, Gd, Gd, Gd, Gd, Gd, Gs, Hhd, Gd, Hhd, Hhd, Md, Gd, Gs, Md, Hh, Hh, Mm, Mm^Xm, Mm^Xm, Mm^Xm, Mm, Md^Xm, Mm^Xm, Hhd, Hhd, Gd, Gd, Rd, Rd, Md, Md^Xm, Hhd, Hhd, Rd, Hhd, Md, Md, Md, Mm, Hhd, Wog, Mm, Mm
Wog, Wog, Wo, Wo, Wo, Wo, Wo, Gs, Ww, Ww, Gs, Rd, Gd, Gd, Gd, Gd, Hhd, Gd, Gd, Gd, Gd, Md, Md, Gs, Md, Mm^Xm, Hh^Vhh, Mm, Mm, Mm, Mm, Mm^Xm, Mm^Xm, Mm, Md, Mm^Xm, Mm, Gd, Hhd, Hhd, Rd, Gd, Hhd, Gd, Rd, Rd, Hhd, Hhd, Hhd, Md, Md^Xm, Md^Xm, Ms^Xm, Mm, Mm
Wo, Wog, Wog, Wo, Wo, Wo, Wo, Ww, Ww, Wo, Gs, Re, Gs, Gd, Gd^Es, Gd, Gd, Gd, Gd, Hhd, Md, Md, Md, Hh, Mm^Xm, Gg^Em, Gs, Mm, Mm, Mm, Mm^Xm, Mm, Mm, Mm, Mm, Mm^Xm, Mm^Xm, Mm, Mm, Gd, Gd, Rd, Rd, Rd, Hhd, Gd, Hhd, Hhd, Gd, Md, Md^Xm, Mm, Mm, Mm, Mm
Wog, Wo, Wo, Wo, Wo, Ww, Gg, Gg, Gg, Gg, Gs, Re, Rd, Rd, Hhd, Gd, Gd, Hhd, Md, Gd, Hhd, Md, Md, Mm, Md, Md, Hh, Mm, Mm, Ms^Xm, Mm, Mm^Xm, Qxu, Mm^Xm, Mm^Xm, Qxu, Mm, Mm, Mm, Hhd, Gd, Gd, Hhd, Gd, Gd, Gd, Gd, Hhd, Md, Md^Xm, Mm, Mm, Mm, Hh, Mm
Wog, Wog, Wo, Wo, Ww, Ww, Gg, Gs, Gs, Gs, Gs, Re, Hhd^Vhhr, Hhd, Md, Hhd, Hhd, Md, Gg, Mm, Mm^Xm, Md, Mm^Xm, Mm, Hh, Hh, Md, Mm, Mm, Mm, Mm, Mm, Mm^Xm, Mm, Mm, Mm^Xm, Mm, Mm, Hhd, Gd, Gd, Gd, Hhd, Gd, Gd, Gd, Hhd, Hhd, Gs, Mm^Xm, Mm^Xm, Mm, Gg, Mm, Mm
Wo, Wo, Wo, Wo, Ww, Hh, Gg, Gg, Hh, Gs, Hh, Re, Hh, Mm, Hh, Md, Mm, Md, Mm, Mm, Mm^Xm, Mm, Mm, Mm, Hh, Gg, Hh, Hh, Hh, Hh, Mm, Mm, Ms^Xm, Ms^Xm, Mm, Mm, Mm, Mm, Hhd^Vhhr, Gd^Dr, Gd, Hhd, Hhd, Gd^Es, Hhd, Gd, Gd, Gd, Hhd, Mm, Mm^Xm, Md, Hh, Hh, Gg
Wo, Wo, Ww, Hh, Wo, Mm, Mm, Hh, Ch, Ch, Chr, Re, Mm, Mm, Gg, Hh, Mm, Mm^Xm, Mm, Hh, Mm, Mm, Mm, Hh, Mm, Mm, Mm, Mm, Mm, Mm, Mm^Xm, Qxu, Mm, Ms^Xm, Mm, Mm, Mm, Mm, Hhd, Gs, Hhd, Gd, Gd, Hhd, Hhd, Hhd, Gd, Md, Md^Xm, Md, Mm^Xm, Mm, Hh, Gg, Rp
Wo, Wo, Wo, Wo, Wo, Ww, Wo, Hh, Khr, Chr, Chr, Re, Chr, Gg, Gs, Hh, Gg, Mm, Hh, Mm, Mm, Mm, Mm, Mm, Mm, Mm, Mm, Mm, Mm, Mm, Ms^Xm, Mm^Xm, Mm^Xm, Mm, Mm, Mm, Mm, Mm, Gd, Hhd, Gs, Hhd, Gd, Gd, Hhd, Gs, Md, Md^Xm, Gg, Mm^Xm, Hh, Gg, Rp, Rp, Gg
Wo, Wo, Wo, Wo, Ww, Wo, Wo, Wo, Ch, Chr, Gg, Re, Re, Gg, Gs, Gg, Gs, Hh, Gg, Hh, Gg^Efm, Mm^Xm, Mm^Xm, Mm, Hh, Hh, Mm, Ms^Xm, Mm, Mm, Mm^Xm, Ms^Xm, Mm^Xm, Mm, Mm, Mm, Hhd, Hhd, Gd, Hhd, Gd, Hhd, Hhd, Hhd, Md, Hhd, Mm^Xm, Mm^Xm, Hh, Mm, Gg, Rp, Hh, Gg, Hh
Wo, Wo, Ww, Wo, Hh, Hh, Gg, Gg, Gg, Gg, Gs, Re, Gs, Re, Re, Gs, Gs, Hh, Gg, Mm, Mm, Mm, Mm^Xm, Hh, Gs, Mm, Wo, Wo, Mm^Xm, Mm^Xm, Ms^Xm, Mm^Xm, Mm, Mm, Mm, Mm, Hhd^Vhhr, Gd, Hhd, Gd, Gd, Gs, Md, Md, Mm^Xm, Wo, Rb^Em, Hh, Gg, Rb, Re, Rp, Rb^Gvs, Gg^Vh, Wwg
Wo, Wo, Gg, Gg, Gg, Gs, Gg, Hh, Gs, Gs, Gs, Re, Hh, Gs, Gs, Re, Re, Gs, Gg, Hh, Hh^Vhh, Wog, Mm^Xm, Hh, Ww, Mm, Wo, Mm, Mm^Xm, Ms^Xm, Mm^Xm, Ms^Xm, Mm, Mm, Mm, Mm, Hhd, Hhd, Gs, Gd^Es, Gd, Hhd, Md, Md^Xm, Hh, Hh, Gg, Gg, Gg, Gg, Gs, Rp, Gg, Rb^Gvs, Wo
Wo, Ww, Gs, Gs, Gs, Gs, Gg, Gs, Gs, Gs, Gg, Re, Gg, Gg, Gg, Gs, Gs, Re, Rb, Gg, Gg, Rb^Gvs, Wo, Wo, Mm^Xm, Wo, Hh, Mm, Mm, Mm^Xm, Mm, Mm, Mm, Mm, Hhd, Hhd, Hhd, Hhd, Hhd, Gd, Hhd, Md, Md, Mm^Xm, Md, Hh^Vhh, Gs, Gs, Gs, Gs, Gs, Rp, Gs, Mm, Wo
Wo, Wo, Gs, Gs, Gg, Wo, Ww, Wo, Wo, Gs, Wo, Re, Gs, Gs, Gs^Vc, Gs, Gs, Gg, Gg, Rb, Rb, Hh, Ww, Hh, Mm, Mm, Mm, Mm, Mm, Mm, Hh, Mm, Hh, Mm, Gd, Hhd, Gd, Hhd, Hhd, Gd, Hhd, Md, Gs, Mm^Xm, Hh, Hh, Hh, Gs, Gs, Gs, Gs, Rp, Rp, Gg^Vc, Wo
Wo, Ww, Ww, Gg, Wo, Wo, Wo, Gg^Vc, Wo, Wo, Ww, Wo^Bw|r, Wo, Ds, Wo, Gg, Gg, Gg, Wwf, Ww, Ww, Wwf, Rb, Gg, Gs, Hh, Mm, Mm^Xm, Mm, Hh, Mm, Hh, Hh, Gs, Gd, Gs, Gd^Es, Gd, Gs, Hhd, Hh, Gs, Gs, Hh, Gs, Gg, Gs, Gs, Gs, Rd, Gg, Gg, Wo^Bw|r, Wo, Mm
Ww, Wo, Wo, Ww, Ww, Ww, Wo, Wo, Ww, Wo, Wo, Wo, Wo, Wo, Ww, Wo, Wo, Wo, Ww, Gg, Gg, Gg, Gg, Re, Re, Re, Re, Mm^Xm, Md, Hh, Mm, Hh, Hh, Hh, Gd, Gd, Gs, Gs, Hh, Hh, Gg, Gs, Gs, Gg, Gs, Gs, Gs, Hh, Gs, Gs, Wo, Wo, Rp, Chr, Rb
Wo, Ww, Wo, Ww, Wo, Wo, Wo, Ww, Wo, Wo, Wo, Ww, Wo, Wo, Wo, Wo, Wo, Wo, Wo, Ww, Ww, Gg, Wwf, Gs, Gg, Gs^Vc, Gs, Re, Re, Hh, Gs, Hh, Gs, Gs, Hh, Gs, Hh, Gs, Gs, Gg, Gs, Gs, Gs, Gs, Gs, Gs, Hh, Gs, Gs, Gs, Wo, Wo, Rp, Gg, Hh
Wo, Wo, Ww, Wo, Ww, Ww, Wo, Wo, Wo, Wo, Wo, Wo, Wo, Wo, Wo, Wo, Wo, Wo, Wo, Ww, Ww, Wo, Gg, Gg, Gg, Gg, Gs, Hh, Hh, Re, Re, Hh, Md, Hh, Hh, Gs, Gs, Gs, Gs, Gs, Gs, Gs, Gg, Gs, Gs, Gs, Gs, Gg, Wo, Hh, Wog, Hh^Vhh, Rp, Gg, Gg
Wo, Wo, Wo, Ww, Wo, Wo, Wo, Wo, Wo, Wo, Ww, Wo, Ww, Wo, Wo, Wo, Wo, Wo, Wo, Ww, Wo, Ww, Ww, Wo, Gg, Gg, Gs, Gs, Gs, Gs, Gs, Re, Re, Md, Re, Re, Re, Gs, Gs, Hh, Gs, Gs, Gs, Gs, Hh, Gs, Hh, Gg, Wo, Wog, Mm, Hh, Rp, Hh, Mm
Wo, Wo, Wo, Wo, Ww, Wo, Wo, Wo, Wo, Wo, Wo, Wo, Ss, Ww, Wo, Ww, Ww, Wo, Ww, Wo, Wo, Ww, Wwf, Wwf, Wwf, Gg, Gg, Gg, Gs, Gs, Gs, Gs, Hh, Re, Gs, Gs, Gs, Re, Rb, Gg, Hh, Hh, Gs^Es, Gs, Re, Gs, Re, Hh, Ww, Mm, Mm, Mm, Rp, Mm, Mm
Wo, Wo^Bw\r, Gg, Gg^Vc, Gg, Gg, Wo, Wo, Wo, Ww, Ss, Wo, Wo, Gg, Wo, Wo, Ww, Wo, Wo, Wo, Ww, Ww, Ww, Ww, Wwf, Gg, Gs, Gg, Gs, Gg, Gs, Gs, Gs, Gs^Es, Hh, Hh, Gs, Gs, Gg, Rb, Re, Gs, Re, Re, Gs, Re, Hh, Re, Wwf, Hh, Hh, Gg, Rp, Mm, Mm
Wo, Wo, Gg, Gg, Gg, Wo, Ww, Wo, Wo, Wo, Ww, Gg, Wo, Gg, Wo, Ww, Wo, Wo, Ww^Vm, Wo, Ww, Ww, Ww, Wwf, Gg, Gg, Gg, Gs, Gg, Gs, Gs, Gs, Hh, Gs, Gs, Gs, Ww, Gg, Gg, Gs, Gs, Re, Gs, Gs, Gs, Hh, Ww, Ww, Wo, Re, Re, Gs, Rp, Gs, Mm
Wo, Wo, Wo, Wo, Wo, Wwf, Wo, Ww, Gg, Gg, Gg, Gg, Ww, Ww, Gg, Wo, Ww, Wwf, Wo, Wwf, Ww, Ww, Wo, Wo, Ww, Gg, Wo, Gs, Gg, Gs, Gs, Gs, Gs, Gs, Ww, Ww, Ww, Ww, Wo, Hh, Gs, Hh, Gg, Gg, Gg, Mm, Wo, Ww, Hh, Hh, Gs, Re, Rp, Hh, Mm
Wo, Wo, Wo, Wo, Wo, Ww, Gg, Gg, Gg, Ss, Ss, Ss, Ss, Gg, Ww, Ss, Wo, Gg, Ww, Wwf, Wo, Ww, Ww, Wo, Wo, Wo, Wo, Gs, Gg, Gs, Hh, Gs, Hh, Gs^Vc, Wo, Wo, Wo, Wo, Wo, Gs^Vc, Gs, Gs, Gs, Gs, Gs, Wo, Ww, Hh, Wo, Gs^Vc, Hh, Gs, Rp, Mm, Hh
Wo, Wo, Wo, Wo, Ww, Wo, Ww, Gg, Ss, Ss, Gg, Ww, Ss, Gg, Ss, Ss, Ww, Gg, Hh, Ww, Ww, Wwf, Ww, Wo, Wo, Wo, Gs, Gg, Gg, Gs, Gs, Gs, Gs, Ww, Wo, Wo, Ww, Wo, Wo, Wo, Wo, Gs, Ww, Ww, Ww, Wo, Ww, Ww, Wo, Ww, Ww, Mm, Gs, Rp, Rp
Wo, Wo, Wo, Wo, Wo, Ww, Wo, Ww, Wo, Wo, Ww, Gg, Gg, Gg, Ss, Gg, Gg, Hh, Ss, Ww, Ss, Ss^Vhs, Gg, Wo, Wo, Wo, Wo, Gs, Gs, Gg, Gg, Gs, Gs, Gs, Gs^Vh, Ww^Bw|, Gs, Gs, Ww, Ww, Gs, Wo, Ww, Ww, Ww, Wo, Ww, Wo, Wo, Ww, Gs, Gs, Gg, Gg, Gg
Wo, Ww, Wo, Wo, Wo, Wo, Wo, Wo, Ww, Wo, Wo, Ww, Ww, Ss^Vhs, Gg, Ww, Ss, Ss, Ww, Ww, Ss, Hh, Mm^Xm, Wo, Wo, Wo, Wo, Gs^Vc, Gs, Gs, Gs, Gs, Gs, Sm^Gvs, Sm^Gvs, Gs, Gs, Gs, Ww, Ww, Ww, Wo, Ww, Ww, Gg, Ww, Ww, Wo, Ww, Ww, Gg, Gs, Gs, Gg, Hh
Wo, Ww, Ww, Wo, Wo, Ww, Ww, Ww, Ww, Wo, Wo, Wo, Ww, Ww, Gg, Ss, Ww, Wo, Hh, Gg, Mm, Hh, Mm, Mm^Xm, Mm^Xm, Hh, Ww, Ww, Ww, Ds, Gs, Gg, Gg, Rb^Gvs, Rb^Gvs, Gg, Gs, Gg, Gg, Gg, Ds, Ds, Gs, Wo, Ww, Gg, Gs, Ww, Gg, Gg, Gg, Gg, Gg, Gg, Gs
