border_size=1
usage=map

Wo, Wo, Gs, Re, Gs, Hhd, Gd, Wo, Hhd, Gd, Gd, Rb, Gd, Gd, Hhd, Gg, Hhd, Rb, Hhd, Md, Md, Md, Rd, Md, Hhd, Md, Md, Md, Hhd, Rd, Rd, Gd, Hhd, Gd, Gd, Gd, Gd, Gd, Hhd^Vhhr, Gd, Gd, Gd, Gd, Gd, Hhd, Gd, Gd, Gd, Hhd, Gd, Hhd
Wo, Wo, Wo, Re, Hh, Gs, Gd, Gd, Hhd, Gd, Hhd, Gd^Es, Gd, Hhd, Hhd, Mm, Hhd, Gd, Hhd, Md, Md, Hhd, Rd, Hhd, Hhd, Md, Md, Hhd, Hhd, Md, Gd, Rd, Rd, Gd, Gd, Gd, Gd, Gd, Gd, Gd, Gd, Gd, Gd, Gd, Hhd, Gd, Gd^Es, Gd, Gd, Gd, Gd
Ww, Ww, Gs^Vc, Re, Gs, Gd, Gd, Gs, Gd, Gd, Gd, Gd, Gs, Hh, Md, Hhd, Gd, Gd, Hhd, Gd, Rd, Rd, Hhd, Gd^Vhr, Gd, Md, Md, Md, Hhd, Gd, Gd, Gd, Gd, Rd, Rd, Gd^Dr, Gd, Gd, Gd, Hhd, Gd, Gd, Hhd, Gd, Gd, Hhd, Gd, Gd, Gd, Hhd, Gd
Ww, Gs, Gs, Re, Re, Gd, Gd, Gd, Gd, Hhd, Gd, Gd, Hhd, Hh, Hhd, Gd, Gd, Gd, Rd, Rd, Gd, Gd, Hhd, Gd, Hhd, Md, Md, Md, Hhd, Gd, Gd, Hhd, Gd^Es, Gd, Hhd, Rd, Gd, Gd, Gd, Gd, Rd^Edpp, Gd, Gd^Edb, Gd, Hhd, Gd, Hhd^Vhhr, Md, Gd, Hhd, Md
Ww, Gg, Gg, Gs, Gs, Rd, Re, Gs, Gd, Gd, Gd, Hhd, Gd, Hhd, Gd, Hhd, Rd, Rd, Gd, Gd, Gd, Gd, Gd^Es, Hhd, Gd, Gs, Md, Md, Hhd, Hhd, Hhd, Gd, Gd, Gd, Hhd, Rd, Gd, Hhd, Gd, Gd^Vhr, Rd, Rd, Hhd, Gd, Gd, Gd, Gd, Hhd, Md, Gd, Gd
Wo, Wo, Wo, Gg, Ww, Gs, Gs, Re, Rd, Gd, Hhd, Gd, Gd, Hhd, Rd, Rd, Gd, Gd, Gd, Gd, Hhd, Gd, Gd, Gd, Gd, Hhd, Hhd, Md, Hhd, Md, Hhd, Hhd, Hhd, Gd, Gd, Rd, Gd, Gd, Gd, Hhd, Hhd, Rd, Gd, Gd^Es, Gd, Gd, Hhd, Gd, Gd, Hhd, Rd
Wo, Wo, Ww, Ww, Wo, Gg, Gg, Gs, Gd, Rd, Rd, Hhd, Rd, Rd, Gd, Gd, Hhd, Gd, Gd, Gd, Hhd, Gd, Gd, Hhd, Gd, Md, Hhd, Md, Hhd, Md, Md, Hhd, Hhd, Gd, Gd, Rd, Gd, Gd, Gd, Hhd, Gd, Gd, Gd, Gd, Hhd, Hhd, Gd, Gd, Hhd, Rd, Hhd
Wo, Wo, Wo, Gg^Vc, Gg, Ww, Gs, Gs, Gs, Gd, Gd, Rd, Hhd, Gd^Vhr, Gd, Gd, Gd, Gd, Gs, Gd, Gd, Gd, Gd, Gd, Hhd, Md, Md, Gg^Efm, Md, Md^Xm, Md, Md, Hhd, Gd, Gd, Rd, Rd, Gd, Hhd, Gd, Gd, Hhd, Gd, Gd, Hhd, Md, Hhd, Gd, Rd, Rd, Gd
Wog, Wo, Wo, Wo, Wo, Gs, Gg, Gs, Gs, Gs, Gd, Rd, Gs, Hhd, Gd, Gd^Es, Gd, Hhd, Gd, Gd, Hhd, Hhd, Gd, Gd, Hhd, Hhd, Md, Md, Md, Hhd, Md^Xm, Md, Md, Hhd, Hhd^Vhhr, Gd, Rd, Gd, Gd, Gd, Gd, Hhd, Gd, Hhd, Gd, Hhd, Rd, Rd, Gd, Gd, Mm
Wog, Wog, Wo, Wo, Wo, Gs, Ww, Gg, Ww, Gs, Gs, Rd, Gd, Hhd, Gd, Gd, Gd, Gd, Gd, Gd, Gd^Es, Gd, Hhd, Gd, Gd, Gd^Dr, Hhd, Md, Mm, Mm, Mm, Md^Xm, Md, Hhd, Hhd, Gd, Rd, Gd, Gd, Gd, Hhd, Hhd, Gd, Gd, Hhd, Hhd, Rd, Hhd, Hhd, Mm, Mm
Wog, Wog, Wog, Wo, Ww, Ds, Ww, Wo, Ww, Gg, Gs^Vc, Re, Gs, Gs, Gd, Hhd, Gd, Hhd, Hhd, Gd, Gd, Gd, Gd, Gd, Gd, Gd, Gs, Md, Hh, Hh, Mm^Xm, Md^Xm, Md, Md, Mm^Xm, Mm, Hhd, Rd, Rd, Hhd, Hhd, Mm, Hhd, Hhd, Gd, Hhd, Rd, Rp, Gd^Dr, Md^Xm, Mm
Wog, Wog, Wo, Wo, Wo, Ww, Ww, Ww, Gs, Ww, Gs, Re, Gd, Gd, Gd, Gd, Gd, Gs, Hhd, Gd, Hhd, Hhd, Md, Gd, Gs, Md, Hh, Hh, Mm, Mm^Xm, Mm^Xm, Mm^Xm, Mm, Md, Mm^Xm, Hhd, Hhd, Gd, Gd, Rd, Rd, Md, Md^Xm, Hhd, Hhd, Rd, Hhd, Md, Md, Md, Mm
Wog, Wog, Wo, Wo, Wo, Wo, Wo, Gs, Ww, Ww, Gs, Rd, Gd, Gd, Gd, Gd, Hhd, Gd, Gd, Gd, Gd, Md, Md, Gs, Md, Mm^Xm, Hh^Vhh, Mm, Mm, Mm, Mm, Mm^Xm, Mm^Xm, Mm, Md, Mm^Xm, Mm, Gd, Hhd, Hhd, Rd, Gd, Hhd, Gd, Rd, Rd, Hhd, Hhd, Hhd, Md, Md^Xm
Wo, Wog, Wog, Wo, Wo, Wo, Wo, Ww, Ww, Wo, Gs, Re, Gs, Gd, Gd^Es, Gd, Gd, Gd, Gd, Hhd, Md, Md, Md, Hh, Mm^Xm, Gg^Em, Gs, Mm, Mm, Mm, Mm^Xm, Mm, Mm, Mm, Mm, Mm^Xm, Mm^Xm, Mm, Mm, Gd, Gd, Rd, Rd, Rd, Hhd, Gd, Hhd, Hhd, Gd, Md, Md^Xm
Wog, Wo, Wo, Wo, Wo, Ww, Gg, Gg, Gg, Gg, Gs, Re, Rd, Rd, Hhd, Gd, Gd, Hhd, Md, Gd, Hhd, Md, Md, Mm, Md, Md, Hh, Mm, Mm, Ms^Xm, Mm, Mm^Xm, Qxu, Mm^Xm, Mm^Xm, Qxu, Mm, Mm, Mm, Hhd, Gd, Gd, Hhd, Gd, Gd, Gd, Gd, Hhd, Md, Md^Xm, Mm
Wog, Wog, Wo, Wo, Ww, Ww, Gg, Gs, Gs, Gs, Gs, Re, Rd, Hhd^Vhhr, Md, Hhd, Hhd, Md, Gg, Mm, Mm^Xm, Md, Mm^Xm, Mm, Hh, Hh, Md, Mm, Mm, Mm, Mm, Mm, Mm^Xm, Mm, Mm, Mm^Xm, Mm, Mm, Hhd, Gd, Gd, Gd, Hhd, Gd, Gd, Gd, Hhd, Hhd, Gs, Mm^Xm, Mm^Xm
Wo, Wo, Wo, Wo, Ww, Hh, Gg, Gg, Hh, Gs, Hh, Re, Hh, Mm, Hh, Md, Mm, Md, Mm, Mm, Mm^Xm, Mm, Mm, Mm, Hh, Gg, Hh, Hh, Hh, Hh, Mm, Mm, Ms^Xm, Ms^Xm, Mm, Mm, Mm, Mm, Hhd^Vhhr, Gd^Dr, Gd, Hhd, Hhd, Gd^Es, Hhd, Gd, Gd, Gd, Hhd, Mm, Mm^Xm
Wo, Wo, Ww, Hh, Wo, Mm, Mm, Hh, Gs, Gs, Chr, Re, Mm, Mm, Gg, Hh, Mm, Mm^Xm, Mm, Hh, Mm, Mm, Mm, Hh, Mm, Mm, Mm, Mm, Mm, Mm, Mm^Xm, Qxu, Mm, Ms^Xm, Mm, Mm, Mm, Mm, Hhd, Gs, Hhd, Gd, Gd, Hhd, Hhd, Hhd, Gd, Md, Md^Xm, Md, Mm^Xm
Wo, Wo, Wo, Wo, Wo, Ww, Wo, Hh, Khr, Chr, Chr, Re, Chr, Gg, Gs, Hh, Gg, Mm, Hh, Mm, Mm, Mm, Mm, Mm, Mm, Mm, Mm, Mm, Mm, Mm, Ms^Xm, Mm^Xm, Mm^Xm, Mm, Mm, Mm, Mm, Mm, Gd, Hhd, Gs, Hhd, Gd, Gd, Hhd, Gs, Md, Md^Xm, Gg, Mm^Xm, Hh
Wo, Wo, Wo, Wo, Ww, Wo, Wo, Wo, Gs, Chr, Gg, Re, Re, Gg, Gs, Gg, Gs, Hh, Gg, Hh, Gg^Efm, Mm^Xm, Mm^Xm, Mm, Hh, Hh, Mm, Ms^Xm, Mm, Mm, Mm^Xm, Ms^Xm, Mm^Xm, Mm, Mm, Mm, Hhd, Hhd, Gd, Hhd, Gd, Hhd, Hhd, Hhd, Md, Hhd, Mm^Xm, Mm^Xm, Hh, Mm, Gg
Wo, Wo, Ww, Wo, Hh, Hh, Gg, Gg, Gg, Gg, Gs, Re, Gs, Re, Re, Gs, Gs, Hh, Gg, Mm, Mm, Mm, Mm, Hh, Gs, Mm, Wo, Wo, Mm^Xm, Mm^Xm, Ms^Xm, Mm^Xm, Mm, Mm, Mm, Mm, Hhd^Vhhr, Gd, Hhd, Gd, Gd, Gs, Md, Md, Mm^Xm, Wo, Rb^Em, Hh, Gg, Rb, Re
Wo, Wo, Gg, Gg, Gg, Gs, Gg, Hh, Gs, Gs, Gs, Re, Hh, Gs, Gs, Re, Re, Gs, Gg, Hh, Hh^Vhh, Wog, Rb^Gvs, Hh, Ww, Mm, Wo, Mm, Mm^Xm, Ms^Xm, Mm^Xm, Ms^Xm, Mm, Mm, Mm, Mm, Hhd, Hhd, Gs, Gd^Es, Gd, Hhd, Md, Md^Xm, Hh, Hh, Gg, Gg, Gg, Gg, Gs
Wo, Ww, Gs, Gs, Gs, Gs, Gg, Gs, Gs, Gs, Gg, Re, Gg, Gg, Gg, Gs, Gs, Re, Rb, Gg, Gg, Rb^Gvs, Wo, Wo, Mm^Xm, Wo, Hh, Mm, Mm, Mm^Xm, Mm, Mm, Mm, Mm, Hhd, Hhd, Hhd, Hhd, Hhd, Gd, Hhd, Md, Md, Mm^Xm, Md, Hh^Vhh, Gs, Gs, Gs, Gs, Gs
Wo, Wo, Gs, Gs, Gg, Wo, Ww, Wo, Wo, Gs, Wo, Re, Gs, Gs, Gs^Vc, Gs, Gs, Gg, Gg, Rb, Rb, Hh, Ww, Hh, Mm, Mm, Mm, Mm, Mm, Mm, Hh, Mm, Hh, Mm, Gd, Hhd, Gd, Hhd, Hhd, Gd, Hhd, Md, Gs, Mm^Xm, Hh, Hh, Hh, Gs, Gs, Gs, Gs
Wo, Ww, Ww, Gg, Wo, Wo, Wo, Gg^Vc, Wo, Wo, Ww, Wo^Bw|r, Wo, Ds, Wo, Gg, Gg, Gg, Wwf, Ww, Ww, Wwf, Rb, Gg, Gs, Hh, Mm, Mm^Xm, Mm, Hh, Mm, Hh, Hh, Gs, Gd, Gs, Gd^Es, Gd, Gs, Hhd, Hh, Gs, Gs, Hh, Gs, Gg, Gs, Gs, Gs, Rd, Gg
Ww, Wo, Wo, Ww, Ww, Ww, Wo, Wo, Ww, Wo, Wo, Wo, Wo, Wo, Ww, Wo, Wo, Wo, Ww, Gg, Gg, Gg, Gg, Re, Re, Re, Re, Mm^Xm, Md, Hh, Mm, Hh, Hh, Hh, Gd, Gd, Gs, Gs, Hh, Hh, Gg, Gs, Gs, Gg, Gs, Gs, Gs, Hh, Gs, Gs, Wo
Wo, Ww, Wo, Ww, Wo, Wo, Wo, Ww, Wo, Wo, Wo, Ww, Wo, Wo, Wo, Wo, Wo, Wo, Wo, Ww, Ww, Gg, Wwf, Gs, Gg, Gs^Vc, Gs, Re, Re, Hh, Gs, Hh, Gs, Gs, Hh, Gs, Hh, Gs, Gs, Gg, Gs, Gs, Gs, Gs, Gs, Gs, Hh, Gs, Gs, Gs, Wo
Wo, Wo, Ww, Wo, Ww, Ww, Wo, Wo, Wo, Wo, Wo, Wo, Wo, Wo, Wo, Wo, Wo, Wo, Wo, Ww, Ww, Wo, Gg, Gg, Gg, Gg, Gs, Hh, Hh, Re, Re, Hh, Md, Hh, Hh, Gs, Gs, Gs, Gs, Gs, Gs, Gs, Gg, Gs, Gs, Gs, Gs, Gg, Wo, Hh, Wog
Wo, Wo, Wo, Ww, Wo, Wo, Wo, Wo, Wo, Wo, Ww, Wo, Ww, Wo, Wo, Wo, Wo, Wo, Wo, Ww, Wo, Ww, Ww, Wo, Gg, Gg, Gs, Gs, Gs, Gs, Gs, Re, Re, Md, Re, Re, Re, Gs, Gs, Hh, Gs, Gs, Gs, Gs, Hh, Gs, Hh, Gg, Wo, Wog, Mm
Wo, Wo, Wo, Wo, Ww, Wo, Wo, Wo, Wo, Wo, Wo, Wo, Ss, Ww, Wo, Ww, Ww, Wo, Ww, Wo, Wo, Ww, Wwf, Wwf, Wwf, Gg, Gg, Gg, Gs, Gs, Gs, Gs, Hh, Re, Gs, Gs, Gs, Re, Rb, Gg, Hh, Hh, Gs^Es, Gs, Re, Gs, Re, Hh, Ww, Mm, Mm
Wo, Wo^Bw\r, Gg, Gg^Vc, Gg, Gg, Wo, Wo, Wo, Ww, Ss, Wo, Wo, Gg, Wo, Wo, Ww, Wo, Wo, Wo, Ww, Ww, Ww, Ww, Wwf, Gg, Gs, Gg, Gs, Gg, Gs, Gs, Gs, Gs^Es, Hh, Hh, Gs, Gs, Gg, Rb, Re, Gs, Re, Re, Gs, Re, Hh, Re, Wwf, Hh, Hh
Wo, Wo, Gg, Gg, Gg, Wo, Ww, Wo, Wo, Wo, Ww, Gg, Wo, Gg, Wo, Ww, Wo, Wo, Ww^Vm, Wo, Ww, Ww, Ww, Wwf, Gg, Gg, Gg, Gs, Gg, Gs, Gs, Gs, Hh, Gs, Gs, Gs, Ww, Gg, Gg, Gs, Gs, Re, Gs, Gs, Gs, Hh, Ww, Ww, Wo, Re, Re
Wo, Wo, Wo, Wo, Wo, Wwf, Wo, Ww, Gg, Gg, Gg, Gg, Ww, Ww, Gg, Wo, Ww, Wwf, Wo, Wwf, Ww, Ww, Wo, Wo, Ww, Gg, Wo, Gs, Gg, Gs, Gs, Gs, Gs, Gs, Ww, Ww, Ww, Ww, Wo, Hh, Gs, Hh, Gg, Gg, Gg, Mm, Wo, Ww, Hh, Hh, Gs
Wo, Wo, Wo, Wo, Wo, Ww, Gg, Gg, Gg, Ss, Ss, Ss, Ss, Gg, Ww, Ss, Wo, Gg, Ww, Wwf, Wo, Ww, Ww, Wo, Wo, Wo, Wo, Gs, Gg, Gs, Hh, Gs, Hh, Gs^Vc, Wo, Wo, Wo, Wo, Wo, Gs^Vc, Gs, Gs, Gs, Gs, Gs, Wo, Ww, Hh, Wo, Gs^Vc, Hh
Wo, Wo, Wo, Wo, Ww, Wo, Ww, Gg, Ss, Ss, Gg, Ww, Ss, Gg, Ss, Ss, Ww, Gg, Hh, Ww, Ww, Wwf, Ww, Wo, Wo, Wo, Gs, Gg, Gg, Gs, Gs, Gs, Gs, Ww, Wo, Wo, Ww, Wo, Wo, Wo, Wo, Gs, Ww, Ww, Ww, Wo, Ww, Ww, Wo, Ww, Ww
Wo, Wo, Wo, Wo, Wo, Ww, Wo, Ww, Wo, Wo, Ww, Gg, Gg, Gg, Ss, Gg, Gg, Hh, Ss, Ww, Ss, Ss^Vhs, Gg, Wo, Wo, Wo, Wo, Gs, Gs, Gg, Gg, Gs, Gs, Gs, Gs^Vh, Ww^Bw|, Gs, Gs, Ww, Ww, Gs, Wo, Ww, Ww, Ww, Wo, Ww, Wo, Wo, Ww, Gs
Wo, Ww, Wo, Wo, Wo, Wo, Wo, Wo, Ww, Wo, Wo, Ww, Ww, Ss^Vhs, Gg, Ww, Ss, Ss, Ww, Ww, Ss, Hh, Mm^Xm, Wo, Wo, Wo, Wo, Gs^Vc, Gs, Gs, Gs, Gs, Gs, Sm^Gvs, Sm^Gvs, Gs, Gs, Gs, Ww, Ww, Ww, Wo, Ww, Ww, Gg, Ww, Ww, Wo, Ww, Ww, Gg
