border_size=1
usage=map

Gg, Wo, Ww, Gg, Ms^Xm, Hh, Ss, Hh, Mm, Hh, Hh, Mm, Mm^Xm, Mm^Xm, Mm^Xm, Mm^Xm, Ms^Xm, Mm^Xm, Mm^Xm, Mm, Uh, Uh, Ql, Uh, Ql, Uh, Uh, Uu, Uu, Uue, Uue, Uu, Uu, Uu, Uu, Uh, Xu, Xu
Gg, Wo, Hh, Ms^Xm, Ms^Xm, Ms^Xm, Hh, Hh, Mm, Mm, Mm, Hh, Ms^Xm, Mm^Xm, Ms, Ms, Ms, Ms, Mm^Xm, Xu, Ql, Ql, Xu, Ql, Xu, Ql, Ql, Uu, Uh, Uh, Uh, Uue, Uh, Uh, Uh, Uu, Uu, Uu
Ww, Ww, Gg, Hh, Hh, Mm, Hh, Ms^Xm, Ms^Xm, Ms^Xm, Ms^Xm, Ms^Xm, Gg^Efm, Mm, Ww, Ww, Ms, Mm, Ql, Ql, Xu, Xu, Urb, Xu, Urb, Xu, Xu, Ql, Ql, Ql, Ql, Uue, Ql, Uh, Ql, Uh, Uh, Uh
Wo, Wo, Gg, Gg, Gg, Gg, Gg^Efm, Hh, Hh, Hh, Mm^Xm, Mm^Xm, Hh, Wo, Mm, Mm, Mm, Ql, Xu, Xu, Urb, Urb, Urb, Urb, Cud, Urb, Cud, Xu, Xu, Xu, Xu, Ql^Bs|, Xu, Ql, Ql, Ql, Ql, Uh
Gg, Gg, Gg, Gg, Gg, Gg, Gg, Gg, Hh^Vhh, Mm^Xm, Mm^Xm, Md, Wo, Wo, Gg, Mm, Xu, Xu, Urb, Urb, Urb, Urb, Urb, Urb, Cud, Kud, Cud, Xu, Urb, Urb, Urb, Urb, Cud, Xu, Xu, Xu, Xu, Ql
Gg, Gg, Gg, Gg, Gg, Hh, Mm, Mm, Mm^Xm, Mm^Xm, Mm, Mm, Ww, Hh, Mm, Mm, Xu, Urb, Urb, Urb, Urb, Urb, Urb, Urb, Urb, Cud, Urb, Xu, Urb, Urb, Urb, Urb, Urb, Xu, Urb, Xu, Urb, Xu
Gg, Gs, Gg, Hh, Mm, Hh, Hh, Mm^Xm, Mm^Xm, Mm, Hh, Ww, Hh, Gg^Efm, Mm, Mm^Xm, Xu, Xu, Xu, Urb, Urb, Urb, Urb, Urb, Urb, Urb, Urb, Xu, Urb, Urb, Urb, Urb, Urb, Urb, Urb, Urb, Urb, Urb
Gg, Gs, Gs, Gg, Gg, Hh, Mm^Xm, Mm^Xm, Mm, Mm, Ww, Ww, Mm, Mm, Mm, Mm^Xm, Cud, Urb, Urb, Xu, Xu, Urb, Urb, Urb, Urb, Urb, Cud, Urb, Xu, Urb, Xu, Urb, Urb, Urb, Urb, Urb, Urb, Urb
Gg, Gs, Gg, Gg, Hh, Hh, Mm^Xm, Mm, Rr, Rr, Wwf^Bsb\, Gg, Hh, Hh, Rr, Mm, Urb, Urb, Urb, Urb, Urb, Urb, Xu, Xu, Urb, Urb, Xu, Ur, Ur, Xu, Uu^Uf, Xu, Xue, Urb, Xu, Urb, Urb, Xu
Gs, Gg, Gg, Gg, Hh^Vhh, Mm^Xm, Ch, Rr, Hh, Ww, Gg, Rr, Rr, Rr, Hh, Rr, Cud, Urb, Urb, Urb, Urb, Urb, Urb, Xu, Xu, Xu, Uue^Ii, Uue, Uue^Ii, Ur, Ur, Uue^Ii, Uue, Xue, Uu^Uf, Xu, Urb, Urb
Gg, Gs, Gg, Hh, Mm^Xm, Mm^Xm, Rb, Rr, Ww, Wo, Gg, Rr, Gs, Hh, Mm, Xu, Xu, Urb, Urb, Urb, Urb, Urb, Urb, Urb, Xu, Xu, Uue, Uue^Ii, Uue^Emf, Uue, Qxu^Ii, Ur, Ur, Uue, Uue, Xu, Urb, Urb
Re, Gs, Gg, Gg, Rb, Rb, Gg, Ch, Ww, Gg, Rr, Rr, Mm^Xm, Hh, Mm, Mm, Xu, Urb, Urb, Urb, Urb, Urb, Urb, Urb, Xu, Uu^Uf, Uue, Uue^Emf, Uue, Uue^Emf, Qxu, Qxu^Ii, Qxu^Ii, Ur, Ur, Xu, Xu, Urb
Gg, Rb, Rb, Rb, Gg, Gg, Ww, Ww, Hh, Ch, Rb, Kh, Mm, Mm^Xm, Mm^Xm, Mm^Xm, Mm, Xu, Xu, Xu, Xu, Xu, Xu, Urb, Urb, Xu, Xu, Uue^Em, Uue, Uue, Uue^Ii, Qxu^Ii, Uue, Uue, Uue, Ur, Ur, Xu
Gg, Gg, Ww, Gg, Ww, Wo, Ww, Mm, Mm, Gg, Rb, Hh, Hh, Mm, Mm, Mm, Mm, Xu, Xu, Xu, Urb, Urb, Urb, Urb, Urb, Urb, Urb, Xu, Xu, Xue, Uu^Uf, Uue^Ii, Uue, Uue, Uue, Uue^Ii, Xu, Urb
Ww, Ww, Ww, Ww, Ww, Wo, Wo, Gg, Wo, Gg, Rb, Gg, Gg, Mm, Mm, Mm, Mm, Mm, Ql, Xu, Urb, Urb, Urb, Urb, Urb, Urb, Urb, Urb, Urb, Xu, Xu, Xu, Uue, Uue, Uue^Emf, Xu, Urb, Xu
Ss, Gg, Hh, Gg, Mm, Mm^Xm, Wo, Wo, Ss, Wo, Wo^Bw|, Gg, Hh, Gg, Hh, Mm, Mm, Mm, Ql, Xu, Xu, Urb, Urb, Urb, Urb, Urb, Urb, Urb, Urb, Urb, Urb, Xu, Xu, Uue, Xu, Xu, Urb, Urb
Hh, Hh, Gg, Hh, Mm, Mm^Xm, Mm, Gg, Hh, Ss, Rb, Wo, Wo, Hh, Gg, Mm, Mm, Mm, Ql, Xu, Xu, Urb, Urb, Urb, Urb, Urb, Urb, Urb, Urb, Urb, Cud, Urb, Urb, Urb, Urb, Urb, Urb, Urb
Hh^Vhh, Hh, Gg, Mm, Ms^Xm, Mm^Xm, Hh, Hh, Mm, Gg, Rb, Ww, Ww, Wo, Ww, Mm, Hh, Mm, Mm, Ql, Ql, Xu, Xu, Xu, Xu, Urb, Xu, Urb, Urb, Urb, Xu, Xu, Urb, Urb, Urb, Urb, Urb, Urb
Mm, Mm, Hh, Gg, Ms^Xm, Mm, Ms^Xm, Ms^Xm, Ms^Xm, Hh, Ms^Xm, Rb, Rb, Wo, Wo, Wo, Wo, Mm, Mm, Mm, Mm, Ql, Ql, Ql, Ql, Xu, Ql, Xu, Xu, Urb, Xu, Urb, Urb, Urb, Urb, Urb, Urb, Urb
Mm^Xm, Hh, Mm^Xm, Mm^Xm, Mm^Xm, Ms^Xm, Mm, Mm, Mm, Ms^Xm, Mm, Ms^Xm, Mm^Xm, Rb, Rb, Md, Wo, Wo, Ww, Mm, Ms, Mm, Mm, Mm, Mm, Ql, Hh, Ql, Ql, Xu, Xu, Xu, Xu, Urb, Xu, Urb, Urb, Urb
Ms^Xm, Mm^Xm, Hh, Mm, Mm, Mm, Mm, Hh, Hh, Mm, Mm^Xm, Hh, Mm^Xm, Mm^Xm, Mm^Xm, Rb, Ww, Mm, Ww, Ms, Ms^Xm, Ms, Mm, Mm, Hh, Mm, Mm, Mm, Mm, Ql, Ql, Ql, Ql, Xu, Xu, Urb, Xu, Xu
Ms^Xm, Ms^Xm, Ww, Gg, Mm, Hh, Mm, Hh, Mm, Mm, Mm, Mm^Xm, Mm, Hh, Mm, Ms^Xm, Ms^Xm, Ms, Wo, Ms, Ms, Ms, Ms^Xm, Ms^Xm, Ms^Xm, Hh, Mm, Mm, Hh, Mm, Mm, Mm, Mm, Ql, Ql, Xu, Ql, Ql
Mm, Hh, Ww, Hh, Hh, Mm, Mm, Mm, Hh, Wo, Mm, Hh, Hh, Mm, Hh, Hh, Mm, Ms^Xm, Mm, Ms^Xm, Ms^Xm, Ms^Xm, Hh, Ms^Xm, Hh, Ms^Xm, Ms^Xm, Ms^Xm, Mm, Hh, Mm, Ms^Xm, Mm, Mm, Mm, Ql, Ql, Ql
