border_size=1
usage=map

Uu, Uu, Uu, Uu, Uu, Uu, Uu, Uu, Uu, Uu, Uu, Uu, Uu, Uu, Uu, Uu, Uu, Uu, Uu, Uu, Uu, Uu, Uu, Uu, Uu, Uu, Uu, Uu, Uu, Uu, Uu, Uu, Uu, Uu, Uu, Uu, Uu, Uu, Uu, Uu, Uu, Uu, Uu, Uu, Uu, Uu, Uu, Uu, Uu, Uu, Uu, Uu
Uu, Uu, Uu, Uu, Uu, Uu, Uu, Uu, Uu, Uu, Uu, Uu, Uu, Uu, Uu, Uu, Uu, Uu, Uu, Uu, Uu, Uu, Uu, Uu, Uu, Uu, Uu, Uu, Uu, Uu, Uu, Uu, Uu, Uu, Uu, Uu, Uu, Uu, Uu, Uu, Uu, Uu, Uu, Uu, Uu, Uu, Uu, Uu, Uu, Uu, Uu, Uu
Uu, Uu, Uu, Uu, Uu, Uu, Uu, Uu, Uu, Uu, Uu, Uu, Uu, Uu, Uu, Uu, Uu, Uu, Uu, Uu, Gd, Uu, Gd, Uu, Mm, Uu, Mm, Uu, Mm, Uu, Hh^Fp, Uu, Gs^Fp, Uu, Gs^Fp, Uu, Gs^Fp, Uu, Gs^Fp, Uu, Gs^Fp, Uu, Gs^Fp, Uu, Gs^Fp, Uu, Gs^Fp, Uu, Uu, Uu, Uu, Uu
Uu, Uu, Uu, Uu, Uu, Uu, Uu, Uu, Uu, Uu, Uu, Uu, Uu, Uu, Uu, Uu, Uu, Uu, Uu, Gd, Gd, Gd, Hhd, Hhd, Mm, Mm, Mm, Mm, Hh^Fp, Hh^Fp, Hh^Fds, Gs^Fp, Gs^Fp, Gs^Fp, Gs^Fms, Gs^Fp, Gs^Fp, Gg^Efm, Gs^Fp, Gs^Fp, Gs^Fp, Gs^Fp, Gs^Fp, Gs^Fp, Gs^Fp, Re, Gs^Fp, Uu, Uu, Uu, Uu, Uu
Uu, Uu, Uu, Uu, Uu, Uu, Uu, Uu, Uu, Uu, Uu, Uu, Uu, Uu, Uu, Uu, Uu, Uu, Uu, Gd, Gd, Gs, Gs, Md, Hh^Vhh, Mm, Mm, Hh^Fp, Hh^Fds, Gs^Fms, Hh^Fms, Gs^Fds, Gs^Fp, Gll^Fp, Gll^Fp, Gs^Fms, Gs^Fp, Gs^Fp, Gs^Fp, Gs^Fp, Gs^Fp, Gs^Fp, Gs^Fms, Gs^Fp, Hh^Fp, Re, Gs^Fp, Uu, Uu, Uu, Uu, Uu
Uu, Uu, Uu, Uu, Uu, Uu, Uu, Uu, Uu, Uu, Uu, Uu, Uu, Uu, Uu, Uu, Uu, Uu, Uu, Gd, Gs, Gs, Hh, Hh^Fp, Hh, Hh^Fp, Hh^Fp, Hh^Fds, Gs^Fp, Gs^Fp, Gs^Fp, Hh^Fms, Gg^Ve, Gs^Fp, Gg^Fet, Gg, Gs^Fms, Gs^Fp, Gg^Efm, Gs^Fms, Gs^Fp, Gs^Fp, Gs^Fp, Gs^Fp, Re, Re, Gs^Fp, Uu, Uu, Uu, Uu, Uu
Uu, Uu, Uu, Uu, Uu, Uu, Uu, Uu, Uu, Uu, Uu, Uu, Uu, Uu, Uu, Uu, Uu, Uu, Uu, Hhd, Hh, Gs, Mm, Hh, Hh^Fp, Gg, Gs^Fp, Gs^Fp, Gs^Fp, Gs^Fp, Gs^Fp, Gs^Fp, Hh^Fms, Gs^Fp, Gs^Fp, Gs^Fms, Gs^Fp, Gs^Fp, Gs^Fms, Gs^Fms, Gs^Fp, Gs^Fp, Gs^Fp, Gs^Fp, Re, Gs^Fp, Gs^Fds, Uu, Uu, Uu, Uu, Uu
Uu, Uu, Uu, Uu, Uu, Uu, Uu, Uu, Uu, Uu, Uu, Uu, Uu, Uu, Uu, Uu, Uu, Uu, Uu, Md, Chr, Hh, Mm, Mm, Mm, Hh^Fp, Gs^Fp, Gs^Fp, Gs^Fp, Gs^Fp, Gs^Fp, Gs^Fp, Gs^Fms, Gs^Fp, Gs^Fp, Gs^Fp, Gs^Fp, Gg^Fet, Gg^Fet, Gs^Fms, Gs^Fp, Gg^Ve, Gs^Fp, Re, Gs^Fms, Gs^Fp, Gs^Fms, Uu, Uu, Uu, Uu, Uu
Uu, Uu, Uu, Uu, Uu, Uu, Uu, Uu, Uu, Uu, Uu, Uu, Uu, Uu, Uu, Uu, Uu, Uu, Uu, Mm, Khr, Chr, Mm, Mm, Mm, Hh^Fds, Gs^Fp, Gs^Fp, Gs^Fp, Gs^Fp, Gg^Fet, Gs^Fp, Gs^Fp, Gs^Fp, Gg^Efm, Gs^Fp, Gg^Fet, Gg^Fet, Gg^Fet, Gg^Fet, Gs^Fp, Hh^Fp, Hh^Fp, Re, Gs^Fp, Gs^Fms, Gs^Fms, Uu, Uu, Uu, Uu, Uu
Uu, Uu, Uu, Uu, Uu, Uu, Uu, Uu, Uu, Uu, Uu, Uu, Uu, Uu, Uu, Uu, Uu, Uu, Uu, Mm, Mm, Mm, Mm, Mm, Hh^Fp, Hh^Fms, Gs^Fp, Gs^Fp, Gs^Fp, Gs^Fp, Gs^Fp, Gs^Fp, Gs^Fp, Gg^Efm, Gs^Fp, Gs^Fp, Gs^Fp, Gs^Fp, Gs^Fp, Gs^Fp, Gs^Fp, Gs^Fp, Re, Re, Gs^Fds, Gs^Fp, Gs^Fms, Uu, Uu, Uu, Uu, Uu
Uu, Uu, Uu, Uu, Uu, Uu, Uu, Uu, Uu, Uu, Uu, Uu, Uu, Uu, Uu, Uu, Uu, Uu, Uu, Mm, Mm, Mm, Mm, Mm, Hh^Fp, Hh^Fms, Hh^Fds, Gs^Fp, Gs^Fp, Gs^Fp, Gs^Fms, Gs^Fp, Gs^Fp, Gs^Fp, Gs^Fp, Gs^Fms, Gs^Fp, Gs^Fp, Gg^Ve, Gs^Fp, Ce, Ke, Ce, Gs^Fms, Gs^Fp, Gs^Fp, Gs^Fp, Uu, Uu, Uu, Uu, Uu
Uu, Uu, Uu, Uu, Uu, Uu, Uu, Uu, Uu, Uu, Uu, Uu, Uu, Uu, Uu, Uu, Uu, Uu, Uu, Mm, Mm, Hh^Vhh, Mm, Mm, Mm, Hh^Fp, Hh^Fp, Gs^Fp, Gs^Fp, Gs^Fms, Gs^Fp, Gs^Fp, Gg^Ve, Gs^Fms, Gs^Fms, Gs^Fp, Gs^Fms, Hh^Fp, Gs^Fp, Gs^Fp, Ce, Ce, Ce, Gs^Fp, Gs^Fp, Gs^Fms, Gs^Fds, Uu, Uu, Uu, Uu, Uu
Uu, Uu, Uu, Uu, Uu, Uu, Uu, Uu, Uu, Uu, Uu, Uu, Uu, Uu, Uu, Uu, Uu, Uu, Uu, Mm, Mm, Mm, Mm, Mm, Mm, Mm, Mm, Hh^Fds, Gs^Fp, Gs^Fp, Gs^Fp, Gs^Fp, Gs^Fp, Gs^Fms, Gs^Fp, Gg^Fet, Gs^Fp, Hh^Fp, Gs^Fp, Gs^Fp, Gs^Fds, Gs^Fp, Gs^Fp, Gs^Fp, Gs^Fp, Gs^Fp, Gs^Fp, Uu, Uu, Uu, Uu, Uu
Uu, Uu, Uu, Uu, Uu, Uu, Uu, Uu, Uu, Uu, Uu, Uu, Uu, Uu, Uu, Uu, Uu, Uu, Uu, Mm, Hh, Mm, Mm, Mm, Mm, Mm, Mm, Hh^Fp, Hh^Fp, Gs^Fp, Hh^Fp, Gs^Fp, Gs^Fp, Gs^Fp, Gs^Fp, Gs^Fp, Gs^Fms, Gs^Fp, Gg^Efm, Gs^Fp, Gs^Fp, Gs^Fp, Gs^Fp, Gs^Fp, Gs^Fp, Gg^Fet, Gs^Fp, Uu, Uu, Uu, Uu, Uu
Uu, Uu, Uu, Uu, Uu, Uu, Uu, Uu, Uu, Uu, Uu, Uu, Uu, Uu, Uu, Uu, Uu, Uu, Uu, Hh, Gs, Hh, Gg, Mm, Mm, Mm, Mm, Mm, Gg, Hh^Fp, Hh^Fp, Hh^Fp, Gs^Fp, Gs^Fp, Gs^Fp, Hh^Fds, Gs^Fp, Gs^Fp, Gs^Fp, Gs^Fp, Gs^Fp, Gs^Fms, Gs^Fp, Gs^Fp, Gs^Fp, Gs^Fp, Gs^Fp, Uu, Uu, Uu, Uu, Uu
Uu, Uu, Uu, Uu, Uu, Uu, Uu, Uu, Uu, Uu, Uu, Uu, Uu, Uu, Uu, Uu, Uu, Uu, Uu, Gs, Gg, Hh, Gs, Mm, Hh, Mm, Mm, Mm, Hh^Fp, Gs^Fp, Gs^Fp, Gs^Fp, Gs^Fp, Hh^Fp, Hh^Fms, Hh^Fds, Gs^Fms, Gs^Fp, Gg^Fet, Gs^Fp, Gs^Fp, Gs^Fp, Gs^Fp, Gg^Efm, Gs^Fp, Gs^Fp, Gs^Fms, Uu, Uu, Uu, Uu, Uu
Uu, Uu, Uu, Uu, Uu, Uu, Uu, Uu, Uu, Uu, Uu, Uu, Uu, Uu, Uu, Uu, Uu, Uu, Uu, Gs, Gs, Gs, Gg, Hh, Gs, Hh^Vhh, Mm, Mm, Gg, Gg, Gg, Gs^Fp, Gs^Fp, Hh^Fp, Hh^Fms, Hh^Fp, Gs^Fp, Gs^Fms, Gs^Fp, Gg^Fet, Gs^Fp, Gs^Fms, Gs^Fp, Gll^Fp, Gs^Fms, Gs^Fp, Gs^Fms, Uu, Uu, Uu, Uu, Uu
Uu, Uu, Uu, Uu, Uu, Uu, Uu, Uu, Uu, Uu, Uu, Uu, Uu, Uu, Uu, Uu, Uu, Uu, Uu, Gs, Gs, Gs, Gg, Gs, Gs, Hh, Hh, Hh^Fp, Gg, Gg, Gs^Fms, Gg, Gg^Efm, Gs^Fp, Gs^Fp, Gs^Fp, Hh^Fms, Gs^Fms, Gs^Fp, Gs^Fp, Gs^Fp, Gs^Fms, Gs^Fds, Gll^Fp, Gll^Fp, Gg, Gs^Fms, Uu, Uu, Uu, Uu, Uu
Uu, Uu, Uu, Uu, Uu, Uu, Uu, Uu, Uu, Uu, Uu, Uu, Uu, Uu, Uu, Uu, Uu, Uu, Uu, Gs, Gs, Gg, Gg, Hh, Hh^Fp, Gs, Gg, Gg, Gs^Fms, Gg, Gg, Gg, Gg, Gs^Fp, Gs^Fp, Gs^Fp, Hh^Fms, Gs^Fp, Gs^Fms, Gs^Fp, Gg^Fet, Gs^Fms, Gs^Fp, Gs^Fp, Gs^Fp, Gs^Fp, Gs^Fp, Uu, Uu, Uu, Uu, Uu
Uu, Uu, Uu, Uu, Uu, Uu, Uu, Uu, Uu, Uu, Uu, Uu, Uu, Uu, Uu, Uu, Uu, Uu, Uu, Gs, Hh, Gg, Mm, Mm, Mm, Hh^Fms, Gg, Gg, Gg, Gg, Gs^Fms, Gg, Gg, Gs^Fp, Hh^Fms, Hh^Fms, Gs^Fp, Gs^Fp, Gs^Fp, Gs^Fp, Gs^Fp, Gg^Ve, Gs^Fms, Gs^Fp, Gs^Fp, Gs^Fp, Gs^Fms, Uu, Uu, Uu, Uu, Uu
Uu, Uu, Uu, Uu, Uu, Uu, Uu, Uu, Uu, Uu, Uu, Uu, Uu, Uu, Uu, Uu, Uu, Uu, Uu, Gs, Hh, Mm, Mm, Mm, Hh^Fp, Gg, Gg, Gg, Gg, Gg, Gg, Gg, Gs^Fp, Gg, Hh^Fms, Gs^Fp, Gs^Fp, Gs^Fp, Gs^Fp, Gs^Fp, Gs^Fp, Gs^Fp, Gs^Fms, Gs^Fp, Gs^Fp, Gs^Fp, Gs^Fms, Uu, Uu, Uu, Uu, Uu
Uu, Uu, Uu, Uu, Uu, Uu, Uu, Uu, Uu, Uu, Uu, Uu, Uu, Uu, Uu, Uu, Uu, Uu, Uu, Hh, Mm, Mm, Mm, Hh^Vhh, Gg, Gg, Hh^Fp, Gg, Gg, Gg, Gg, Gs^Fp, Hh^Fms, Gg, Gg, Gs^Fp, Gs^Fp, Gg^Fet, Gs^Fp, Gs^Fms, Gg^Efm, Gs^Fp, Gs^Fp, Gs^Fms, Gs^Fp, Gg^Fet, Gg^Fet, Uu, Uu, Uu, Uu, Uu
Uu, Uu, Uu, Uu, Uu, Uu, Uu, Uu, Uu, Uu, Uu, Uu, Uu, Uu, Uu, Uu, Uu, Uu, Uu, Mm, Mm, Mm, Mm, Hh, Gg, Hh, Hh^Fms, Hh^Fp, Hh, Hh^Fp, Gg, Gg, Gg, Gg, Gg, Gs^Fp, Gs^Fp, Gs^Fp, Gs^Fp, Gg^Efm, Gs^Fp, Gs^Fp, Gs^Fp, Gs^Fms, Gs^Fms, Gs^Fds, Gs^Fp, Uu, Uu, Uu, Uu, Uu
Uu, Uu, Uu, Uu, Uu, Uu, Uu, Uu, Uu, Uu, Uu, Uu, Uu, Uu, Uu, Uu, Uu, Uu, Uu, Mm, Mm, Mm, Mm, Gg, Gg, Hh, Hh, Hh, Hh, Hh, Gg, Gg, Gg, Gg, Gg, Gg, Gs^Fp, Gs^Fp, Gs^Fp, Gs^Fp, Gs^Fp, Gs^Fp, Gs^Fp, Gs^Fp, Gg^Fet, Gs^Fms, Gs^Fms, Uu, Uu, Uu, Uu, Uu
Uu, Uu, Uu, Uu, Uu, Uu, Uu, Uu, Uu, Uu, Uu, Uu, Uu, Uu, Uu, Uu, Uu, Uu, Uu, Mm, Mm, Mm, Hh^Fms, Gg, Gg, Gg, Gg, Hh, Hh^Fp, Hh, Gg, Gg, Gg, Gs^Fp, Gg, Gg, Gg, Gs^Fp, Gs^Fp, Gs^Fp, Hh^Fms, Gs^Fp, Gs^Fp, Gg^Fet, Gs^Fp, Gs^Fp, Gs^Fms, Uu, Uu, Uu, Uu, Uu
Uu, Uu, Uu, Uu, Uu, Uu, Uu, Uu, Uu, Uu, Uu, Uu, Uu, Uu, Uu, Uu, Uu, Uu, Uu, Mm, Ms, Mm, Hh^Fp, Hh^Fp, Hh, Gg, Gg, Hh, Hh, Hh^Fms, Gg, Gg, Gg, Gg, Gg, Gg, Gg, Gs^Fp, Gs^Fp, Gs^Fms, Gs^Fp, Hh^Fms, Gs^Fms, Gs^Fms, Gs^Fms, Gs^Fms, Gg^Ve, Uu, Uu, Uu, Uu, Uu
Uu, Uu, Uu, Uu, Uu, Uu, Uu, Uu, Uu, Uu, Uu, Uu, Uu, Uu, Uu, Uu, Uu, Uu, Uu, Ms, Mm, Mm, Hh, Gg, Hh, Hh, Hh, Hh, Mm, Hh^Fp, Hh^Fp, Gg, Gg, Gg, Gg, Gg, Gg, Gg, Gg, Gs^Fp, Gs^Fp, Gs^Fp, Gs^Fp, Gs^Fp, Gs^Fp, Gs^Fp, Gs^Fds, Uu, Uu, Uu, Uu, Uu
Uu, Uu, Uu, Uu, Uu, Uu, Uu, Uu, Uu, Uu, Uu, Uu, Uu, Uu, Uu, Uu, Uu, Uu, Uu, Ms, Mm, Mm, Mm, Hh^Fp, Gg, Gg, Hh^Vhh, Mm, Mm, Mm, Gg, Gg, Gg, Gg, Gg, Gg, Gg, Gs, Gg, Gg, Gg, Gg, Gg, Gg^Efm, Gs^Fp, Hh^Fms, Gs^Fp, Uu, Uu, Uu, Uu, Uu
Uu, Uu, Uu, Uu, Uu, Uu, Uu, Uu, Uu, Uu, Uu, Uu, Uu, Uu, Uu, Uu, Uu, Uu, Uu, Mm, Mm, Hh, Hh, Hh^Fp, Gg, Gg, Hh^Fp, Mm, Mm, Mm, Gg, Gg, Gg, Gg, Gg, Gs, Gg, Gg, Gs, Gg, Gg, Gg, Gg, Gg, Gg, Gs^Fp, Gs^Fp, Uu, Uu, Uu, Uu, Uu
Uu, Uu, Uu, Uu, Uu, Uu, Uu, Uu, Uu, Uu, Uu, Uu, Uu, Uu, Uu, Uu, Uu, Uu, Uu, Mm, Mm, Gg, Gg, Gg, Hh, Hh, Hh, Hh^Fms, Hh, Gg, Gs, Gs, Gg, Gg, Gg, Gs, Gs, Gs, Gg, Gs^Fp, Gs^Fp, Gg, Gg, Gs, Gg, Gg, Hh^Fp, Uu, Uu, Uu, Uu, Uu
Uu, Uu, Uu, Uu, Uu, Uu, Uu, Uu, Uu, Uu, Uu, Uu, Uu, Uu, Uu, Uu, Uu, Uu, Uu, Mm, Hh^Vhh, Hh, Hh, Hh, Mm, Mm, Hh, Hh, Gg, Gs, Gs, Gs, Gg, Hh^Fp, Hh^Fp, Gs^Fp, Gg, Gg, Gg, Hh^Fp, Gs, Gs^Fp, Gg, Gg, Gg, Hh^Fp, Ms, Uu, Uu, Uu, Uu, Uu
Uu, Uu, Uu, Uu, Uu, Uu, Uu, Uu, Uu, Uu, Uu, Uu, Uu, Uu, Uu, Uu, Uu, Uu, Uu, Hh, Hh, Hh, Mm, Gg, Mm, Hh^Fp, Hh, Hh, Gs, Gs, Gg, Gs, Gg, Gs^Fp, Gg, Gg, Gg, Gg, Gs^Fp, Gs^Fp, Gg, Gg, Gs^Fp, Gs^Fp, Hh^Fp, Hh^Fp, Mm^Xm, Uu, Uu, Uu, Uu, Uu
Uu, Uu, Uu, Uu, Uu, Uu, Uu, Uu, Uu, Uu, Uu, Uu, Uu, Uu, Uu, Uu, Uu, Uu, Uu, Mm, Hh^Fp, Hh^Fp, Hh^Fms, Mm, Hh, Mm, Hh, Gs, Gg, Gg, Gg, Gs, Gg, Gg, Gs^Fp, Gg, Gg^Vc, Gg, Hh^Fp, Hh^Fp, Gs^Fp, Gs^Fp, Gg, Gg, Hh^Fp, Mm^Xm, Mm, Uu, Uu, Uu, Uu, Uu
Uu, Uu, Uu, Uu, Uu, Uu, Uu, Uu, Uu, Uu, Uu, Uu, Uu, Uu, Uu, Uu, Uu, Uu, Uu, Hh, Mm, Hh^Fms, Mm, Hh, Hh, Hh, Gg^Efm, Gg, Gg, Gs, Gs^Fp, Gg, Gg, Gg, Hh, Hh^Fp, Hh, Hh, Mm, Hh^Fmw, Gs, Gs, Gg, Gg, Gg, Mm^Xm, Mm, Uu, Uu, Uu, Uu, Uu
Uu, Uu, Uu, Uu, Ss, Uu, Ss, Uu, Ss, Uu, Gg, Uu, Ww, Uu, Hh, Uu, Gg, Uu, Mm, Hh, Hh^Fp, Hh, Hh, Hh, Gg, Gg, Gg, Gs, Gs, Hh^Fp, Gg, Gg^Efm, Gg, Gg, Gg, Hh, Mm, Ms, Mm, Hh, Gg, Gg, Gg, Gg, Mm, Mm^Xm, Mm^Xm, Uu, Uu, Uu, Uu, Uu
Uu, Uu, Uu, Gg, Gg, Gg, Gg, Gg, Ss, Gg, Ss, Gg, Ww, Gg, Hh, Gg, Hh, Mm, Mm, Hh, Hh, Hh^Fms, Hh^Fp, Gg, Gg, Gg, Hh, Gg, Hh, Gg, Gg, Gg, Hh, Gg^Efm, Hh, Hh^Fp, Mm^Xm, Mm^Xm, Gg, Hh^Vhh, Gg, Gs, Gg, Hh, Hh^Fp, Mm, Mm, Mm^Xm, Uu, Uu, Uu, Uu
Uu, Uu, Uu, Ww, Wo, Gg, Ss^Vhs, Ss, Ss, Gg, Gg, Wo, Ss, Gg, Gg, Hh, Hh, Mm, Mm, Gg, Mm, Hh, Gg, Hh^Fms, Hh^Fms, Hh^Fms, Hh, Hh, Gs, Gg^Efm, Gs, Gg, Gg, Hh, Mm, Mm, Mm^Xm, Mm, Hh, Gs, Gg, Gs, Gg, Hh, Hh^Fdw, Mm, Mm, Mm^Xm, Uu, Uu, Uu, Uu
Uu, Uu, Uu, Ww, Gg, Ww, Gg, Ss, Ss, Gg, Ss, Wo, Ss, Gg, Gg, Hh, Gg, Hh, Hh, Mm, Mm, Mm, Hh, Hh, Mm, Mm, Hh, Gg, Gg, Gg, Gs, Gg, Hh, Gg^Efm, Mm, Mm^Xm, Mm, Hh^Fms, Hh, Hh, Gg^Efm, Gg, Gg^Efm, Hh, Gg, Mm, Mm^Xm, Mm^Xm, Uu, Uu, Uu, Uu
Uu, Uu, Uu, Ww, Ww, Ww, Ss, Ss, Ss, Ss, Ss, Ww, Ww, Ss, Ss, Gg, Gg, Hh, Gg, Gg, Hh, Hh, Mm, Mm, Mm, Hh, Ce, Ke, Ce, Gg, Gg, Gg, Hh, Mm, Ms, Mm^Xm, Mm^Xm, Hh^Fdw, Gg, Gg, Gg, Gg, Hh, Mm, Mm^Xm, Mm^Xm, Mm, Hh^Fp, Uu, Uu, Uu, Uu
Uu, Uu, Uu, Wo, Wo, Ww, Ww, Gg, Gg, Ss, Sm, Ss, Ww, Gs^Vc, Gg, Ss, Gg, Gg, Ss, Hh, Gg, Hh^Fms, Gg, Hh, Hh, Gg, Gg, Ce, Gg, Gg^Efm, Gg, Hh, Mm, Mm, Ms, Ms, Mm^Xm, Mm, Hh, Gs, Gg, Gg, Hh, Ha^Vhha, Mm^Xm, Mm, Mm, Mm^Vc, Uu, Uu, Uu, Uu
Uu, Uu, Uu, Wo, Ww, Gg, Ww, Ww, Ww, Ss, Ss, Wo, Ww, Ss, Ss, Gg, Ss, Ss, Gg, Ss, Ss, Gg, Gg, Gg, Gg^Efm, Gg, Gg, Gg, Gg, Gg, Gg, Hh^Vhh, Gg, Ww, Mm, Mm, Mm^Xm, Mm, Mm, Gs, Gg, Gg, Gg, Mm, Mm, Mm^Xm, Mm, Hh, Uu, Uu, Uu, Uu
Uu, Uu, Uu, Ww, Ww, Ww, Gs, Wo, Wo, Wo, Ww, Ww, Ss, Ww, Ss, Ss, Ww, Ss, Ss, Gg, Gg, Ss, Gg, Ss, Gg, Gg, Ss, Gg, Ss, Gg, Gg, Gg, Gg, Ww, Hh^Fmw, Mm, Mm, Mm^Xm, Mm^Xm, Hh, Gg, Gg, Gg, Mm, Mm^Xm, Mm^Xm, Hh, Hh, Uu, Uu, Uu, Uu
Uu, Uu, Uu, Gg, Ss, Gg, Gg, Gg, Ss, Ww, Ww, Gg, Gg, Ss, Gg, Ss, Wo, Ss, Gg, Gg, Ss, Gg, Ss, Gg, Ss, Gg, Ss, Gg, Gg, Gg, Ss, Gg, Ww, Wwf, Gg, Gg, Hh^Fmw, Mm, Mm^Xm, Mm, Mm, Gg, Gg, Mm, Mm^Xm, Mm, Gs^Fp, Hh, Uu, Uu, Uu, Uu
Uu, Uu, Uu, Gg, Gg, Gg, Ss, Gg, Ss^Vhs, Ww, Wo, Gg, Ss, Ss, Ss, Ww, Wo, Ww, Ss, Ss, Gg, Ss, Gg^Efm, Ss, Ss, Gg, Gg, Ss, Ds, Ss, Wo, Wo, Ss, Gg^Efm, Gg^Efm, Gg, Hh, Mm, Mm, Mm^Xm, Mm^Xm, Mm, Hh, Mm, Mm^Xm, Mm, Gg, Hh^Fmw, Uu, Uu, Uu, Uu
Uu, Uu, Uu, Gg, Gg, Ss, Ss, Gg, Ss, Ww, Wo, Ww, Ww, Ss^Vhs, Ss, Ss, Ww, Ww, Gg, Ss, Gg, Gg^Efm, Ss^Vhs, Ss, Gg^Efm, Ss, Ss, Ss, Ww, Ww, Ss, Ss, Ss, Ww, Gg^Efm, Gg, Gg, Gg^Efm, Ww, Ha, Mm^Xm, Mm, Hh, Hh, Mm^Xm, Mm, Gg, Hh^Fmw, Uu, Uu, Uu, Uu
Uu, Uu, Uu, Gg, Ss, Gg, Gg, Gg, Gg, Ss, Gg, Wo, Ww, Ss, Sm, Wwf, Ss, Ss, Sm, Ss, Ss, Ss, Ss, Ss, Gg, Gg, Gg, Gg, Ww, Ww, Ss, Ss, Ss, Ss, Gg, Gg, Ww, Wwf, Gs^Fp, Hh, Mm, Mm, Mm, Hh, Mm^Xm, Mm, Gg^Efm, Gg, Uu, Uu, Uu, Uu
Uu, Uu, Uu, Gg, Gg, Ss, Gg, Gg, Gg, Gg, Ss, Ww, Ww, Wo, Ss, Ss, Ww, Ss, Ww, Ss, Ss, Gg, Gg, Ss, Ss, Gg, Ss, Ss, Ww, Ww, Ss, Ss, Ss, Ss, Ww, Ww, Ww, Gs^Fp, Gs^Fp, Chr, Khr, Hh^Fp, Mm, Mm^Xm, Mm, Mm, Hh, Mm, Uu, Uu, Uu, Uu
Uu, Uu, Uu, Gg, Gg, Ss, Ss, Ss, Ss, Ss, Ss, Ss, Ww, Ww, Ww, Gg, Gg, Ss, Gg, Ss, Ss, Gg, Ss, Ss, Ss, Gg^Efm, Ss, Ss, Ww, Ss, Gg, Ss, Ss, Ww, Ww, Ss, Gg, Gg, Gs, Chr, Chr, Mm^Vhh, Mm, Mm^Xm, Mm^Xm, Mm, Mm, Ms, Uu, Uu, Uu, Uu
Uu, Uu, Uu, Hh, Ss, Ss, Hh, Gg, Ss, Sm, Gg, Ss, Ww, Ss, Wo, Ss, Ss, Gg, Gg, Gg, Gg, Ww, Ss, Gg^Efm, Ss, Ss, Wo, Wo, Ss, Gg, Gg^Efm, Gg, Ds, Ww, Ss, Ss, Gg, Rb, Hh^Fp, Hh, Gg, Hh^Fmw, Mm, Mm, Mm^Xm, Mm^Xm, Mm, Mm, Uu, Uu, Uu, Uu
Uu, Uu, Uu, Gg, Rb, Gg, Rb, Ss, Gg, Ss, Ss, Gg, Wo, Ss, Ww, Ss, Ss, Ss, Gg, Ss, Ss, Ss, Ss, Khs, Ss, Ds, Wo, Ww, Ss, Ss^Vhs, Ss, Gg, Ds, Wo, Ss, Ss, Rb, Rb, Gg, Hh^Fms, Gg^Efm, Hh^Fmw, Hh, Mm, Mm^Xm, Mm, Mm, Mm, Uu, Uu, Uu, Uu
Uu, Uu, Uu, Rb, Ss, Rb, Gg, Rb, Rb, Hh, Gg, Gg, Ss, Wo, Ww, Wo, Wo, Ss^Vhs, Gg, Ss, Ss, Ss, Ss, Chs, Chs, Wo, Ww, Ss, Rb, Ss, Rb, Ss, Re, Ww, Rb, Rb, Ss, Gg, Gg, Gg, Hh, Mm^Vhh, Hh, Mm^Xm, Mm^Xm, Mm, Mm, Mm, Uu, Uu, Uu, Uu
Uu, Uu, Uu, Hh, Hh, Hh, Gg, Hh, Ch, Rb, Rb, Ss, Ss, Ww, Ss, Ww, Ww, Ss, Ss, Gg, Ss, Ss, Gg^Efm, Chs, Ss, Ww, Ww, Rb, Ss, Rb, Ss, Rb, Ss, Ww, Gg, Gg^Efm, Gg, Ss, Gg^Efm, Gg^Efm, Gg^Efm, Hh, Hh, Mm, Mm, Mm^Xm, Mm, Hh^Fms, Uu, Uu, Uu, Uu
Uu, Uu, Uu, Hh, Gg, Gs, Hh, Hh, Ch, Gg, Rb, Gg, Ss, Ss, Gg, Wo, Gg, Ww, Gg, Ss, Ss, Gg, Ss, Gg, Rb, Rb, Ww, Ss, Ss, Ss, Ds, Ss, Ss, Ww, Ww, Gg^Efm, Ds, Gg, Hh, Hh^Fms, Gg, Gg^Efm, Hh, Mm, Mm, Mm, Mm, Ke, Uu, Uu, Uu, Uu
Uu, Uu, Uu, Gg, Mm, Gg, Hh^Vhh, Hh, Kh, Hh, Re, Gg, Gg, Gg, Ww, Ww, Ww, Ww, Gg, Ss, Ss, Ss, Rb, Rb, Gg^Efm, Gg, Ds, Ww, Ss, Ss, Wo, Ds, Ww, Ww, Ww, Ds, Gg, Ss, Hh, Gg, Gg, Gg, Gg^Efm, Hh, Hh^Fds, Mm, Mm, Ce, Uu, Uu, Uu, Uu
Uu, Uu, Uu, Mm, Mm, Hh, Mm, Mm, Gs, Ch, Gg, Rb, Ww^Bw\, Wo, Gg, Gg, Ww, Ww, Wo, Ss, Rb, Rb, Ss, Ss, Ss, Ds, Ds, Ww, Ww, Wo, Ww, Ww, Ww, Ww, Ds, Gg, Ww, Gg, Gg, Gg, Gg, Gg^Efm, Gg^Efm, Hh, Hh^Fds, Mm, Mm, Gg, Uu, Uu, Uu, Uu
Uu, Uu, Uu, Wo, Ww, Wo, Wo, Mm, Wwf, Ds, Ww, Gg, Ww, Rb, Re, Gg, Gs, Ww, Wwf, Rb, Ss, Ss^Vhs, Ss, Ss, Gg, Ds, Ww, Ww, Ww, Ww, Ww, Ss, Gg^Efm, Ds, Ww, Ww, Ww, Gg, Gg, Gg, Ds, Wo, Gs^Vht, Gg, Gg, Hh, Hh, Gg, Uu, Uu, Uu, Uu
Uu, Uu, Uu, Ww, Ww, Ww, Wo, Wwr, Ww, Ww, Ww, Ww, Ww, Gs, Gs, Re, Re, Wwf, Ww, Ss, Ss, Ss, Ds, Gg, Ww, Ww, Wo, Ww, Ds, Ww, Ss^Vm, Ss, Ww, Ww, Ww, Wo, Wo, Ww, Ww, Ww, Ww, Gg^Efm, Ds, Gg, Ds, Gg, Ww, Ds, Uu, Uu, Uu, Uu
Uu, Uu, Uu, Ww, Ww, Wo, Ww, Wwf, Wwr, Wo, Ww, Wwf, Ww, Ds, Ds, Gs, Ds, Wo^Bw\, Wo, Ww, Ss, Ss, Ww, Ww, Ww, Wo, Ww, Ww, Ww, Ww, Ww, Ww, Wo, Wo, Wo, Wo, Wo, Wo, Wo, Wo, Wo, Ww, Ww, Ds, Ww, Ww, Ww, Wo, Uu, Uu, Uu, Uu
Uu, Uu, Uu, Wo, Wo, Ww, Wo, Ww, Wwf, Wo, Wo, Wwr, Ww, Ww, Wo, Wo, Ww, Ww, Wo, Wo, Ww, Ww, Wo, Ww, Wo, Wo, Wo, Ww, Wo, Ww, Ww, Ww, Ww, Wo, Wo, Wo, Wo, Wo, Wo, Wo, Wo, Wo, Ww, Wwr, Ww, Ww, Ww, Wo, Uu, Uu, Uu, Uu
Uu, Uu, Uu, Ww, Wo, Wo, Wo, Wo, Wo, Wwr, Ww, Wo, Wo, Wo, Ww, Wo, Wo, Wo, Ww, Ww, Ww, Wo, Wo, Wo, Wo, Wo, Ww, Ww, Ww, Ww, Wo, Wwr, Wo, Wo, Wo, Wo, Wo, Ww, Wo, Ww, Wo, Wo, Wo, Wwr, Wo, Wo, Wo, Wo, Uu, Uu, Uu, Uu
Uu, Uu, Uu, Wo, Wo, Wo, Hh, Wwr, Wo, Wwr, Wo, Ww, Wo, Wwr, Wwf, Wo, Wo, Wo, Ww, Wo, Wo, Wo, Wo, Wo, Wo, Wo, Ww, Ds, Ww, Ww, Ww, Ww, Wo, Wo, Wo, Wo, Wo, Wo, Wo, Wo, Wo, Wo, Wo, Wo, Wo, Wo, Wwr, Wwr, Uu, Uu, Uu, Uu
Uu, Uu, Uu, Wo, Wo, Wo, Gs, Wwr, Wo, Wo, Wo, Wo, Wo, Wo, Wo, Wo, Wo, Wo, Wo, Wo, Wo, Wo, Wo, Wo, Wo, Wwr, Ww, Gs, Wo, Wo, Wo, Wo, Wo, Wo, Wo, Wo, Wo, Wo, Wo, Wo, Wo, Wo, Wo, Wo, Ww, Ww, Wo, Wo, Uu, Uu, Uu, Uu
Uu, Uu, Uu, Wo, Wo, Wo, Ds, Gs^Vc, Wo^Bw\, Wo, Wo, Wo, Wo, Wo, Wo, Wo, Wo, Wo, Wo, Wo, Wo, Wo, Wo, Wo, Wo, Wwr, Ww, Wo, Ww, Wwr, Wo, Wo, Wo, Wo, Wo, Wo, Wo, Wo, Wo, Wo, Wo, Wo, Gg, Gg, Gg, Wo, Wo, Wo, Uu, Uu, Uu, Uu
Uu, Uu, Uu, Ww, Uu, Ww, Uu, Gs, Uu, Wo, Uu, Wo, Uu, Wo, Uu, Wo, Uu, Wo, Uu, Wo, Uu, Wo, Uu, Wo, Uu, Wwr, Uu, Ww, Uu, Wo, Uu, Wo, Uu, Wo, Uu, Wo, Uu, Wo, Uu, Wo, Uu, Hh, Uu, Hh, Uu, Ds, Uu, Wo, Uu, Uu, Uu, Uu
Uu, Uu, Uu, Uu, Uu, Uu, Uu, Uu, Uu, Uu, Uu, Uu, Uu, Uu, Uu, Uu, Uu, Uu, Uu, Uu, Uu, Uu, Uu, Uu, Uu, Uu, Uu, Uu, Uu, Uu, Uu, Uu, Uu, Uu, Uu, Uu, Uu, Uu, Uu, Uu, Uu, Uu, Uu, Uu, Uu, Uu, Uu, Uu, Uu, Uu, Uu, Uu
Uu, Uu, Uu, Uu, Uu, Uu, Uu, Uu, Uu, Uu, Uu, Uu, Uu, Uu, Uu, Uu, Uu, Uu, Uu, Uu, Uu, Uu, Uu, Uu, Uu, Uu, Uu, Uu, Uu, Uu, Uu, Uu, Uu, Uu, Uu, Uu, Uu, Uu, Uu, Uu, Uu, Uu, Uu, Uu, Uu, Uu, Uu, Uu, Uu, Uu, Uu, Uu
