border_size=1
usage=map

Gg, Gg, Gg, Gg, Gg, Gg, Gg, Gg, Gg, Gg, Gg, Gg, Gg, Gg, Gg, Gg, Gd, Gd, Gd, Gd, Hhd, Mm, Mm, Mm, Mm, Mm, Hh^Fp, Hh^Fp, Gs^Fp, Gs^Fp, Gs^Fp, Gs^Fp, Gs^Fp, Gs^Fp, Gg^Efm, Gs^Fp, Gs^Fp, Gs^Fp, Gs^Fp, Gs^Fp, Gs^Fp, Gs^Fp, Re, Gs^Fp, Gs^Fp, Gs^Fp, Gs^Fp, Gs^Fp, Gs^Fp, Gs^Fp, Gg, Gg, Gg, Gg, Gg, Gg, Gg, Gg, Gg, Gg
Gg, Gg, Gg, Gg, Gg, Gg, Gg, Gg, Gg, Gg, Gg, Gg, Gg, Gg, Gg, Gg, Gd, Gd, Gs, Hhd, Md, Mm, Mm, Mm, Hh^Fp, Hh^Fp, Gs^Fms, Hh^Fds, Gs^Fds, Gs^Fp, Gll^Fp, Gs^Fms, Gs^Fms, Gs^Fp, Gs^Fp, Gs^Fp, Gs^Fp, Gs^Fp, Gs^Fp, Gs^Fp, Gs^Fp, Gs^Fp, Re, Gs^Fp, Gs^Fp, Gs^Fp, Gs^Fp, Gs^Fp, Gs^Fp, Gs^Fp, Gg, Gg, Gg, Gg, Gg, Gg, Gg, Gg, Gg, Gg
Gg, Gg, Gg, Gg, Gg, Gg, Gg, Gg, Gg, Gg, Gg, Gg, Gg, Gg, Gg, Gg, Gd, Gd, Gs, Gs, Hh^Fp, Hh^Vhh, Hh^Fp, Mm, Hh^Fds, Hh^Fds, Gs^Fp, Hh^Fms, Hh^Fms, Gs^Fp, Gs^Fp, Gll^Fp, Gg, Gs^Fp, Gs^Fp, Gs^Fp, Gs^Fms, Gs^Fp, Gs^Fp, Gs^Fms, Gs^Fp, Hh^Fp, Re, Gs^Fp, Gs^Fms, Gg^Efm, Gs^Fms, Gs^Fds, Gs^Fp, Gs^Fp, Gg, Gg, Gg, Gg, Gg, Gg, Gg, Gg, Gg, Gg
Gg, Gg, Gg, Gg, Gg, Gg, Gg, Gg, Gg, Gg, Gg, Gg, Gg, Gg, Gg, Gg, Hhd, Gs, Gs, Hh, Hh, 1 Hh, Gg, Hh^Fp, Gs^Fp, Gs^Fp, Gs^Fp, Gs^Fp, Gs^Fp, Gg^Ve, Gs^Fp, Gg^Fet, Gs^Fms, Gs^Fms, Gs^Fp, Gg^Efm, Gs^Fms, Gs^Fp, Gs^Fp, Gs^Fp, Gs^Fp, Re, Gs^Fp, Gs^Fp, Hh^Fp, Gs^Fp, Gs^Fms, Gs^Fp, Gs^Fp, Gg^Efm, Gg, Gg, Gg, Gg, Gg, Gg, Gg, Gg, Gg, Gg
Gg, Gg, Gg, Gg, Gg, Gg, Gg, Gg, Gg, Gg, Gg, Gg, Gg, Gg, Gg, Gg, Md, Hh, Hh, Mm, Mm, Hh^Fp, Hh^Fp, Gs^Fp, Gs^Fp, Gs^Fp, Gs^Fp, Gs^Fp, Gs^Fp, Hh^Fms, Gs^Fp, Gs^Fp, Gs^Fp, Gs^Fp, Gg^Fet, Gs^Fms, Gs^Fms, Gs^Fp, Gg^Ve, Gs^Fp, Re, Re, Gs^Fp, Gs^Fds, Gs^Fp, Gs^Fp, Gs^Fp, Gg^Fet, Gs^Fp, Gg^Efm, Gg, Gg, Gg, Gg, Gg, Gg, Gg, Gg, Gg, Gg
Gg, Gg, Gg, Gg, Gg, Gg, Gg, Gg, Gg, Gg, Gg, Gg, Gg, Gg, Gg, Gg, Mm, Chr, Chr, Mm, Mm, Mm, Hh^Fds, Gs^Fp, Gs^Fp, Gs^Fp, Gs^Fp, Gs^Fp, Gs^Fp, Gs^Fms, Gs^Fp, Gs^Fp, Gs^Fp, Gs^Fp, Gg^Fet, Gg^Fet, Gg^Fet, Gs^Fp, Hh^Fp, Gs^Fp, Re, Gs^Fms, Gs^Fms, Gs^Fms, Gs^Fp, Gs^Fp, Gs^Fp, Gs^Fds, Gs^Fp, Gs^Fp, Gg, Gg, Gg, Gg, Gg, Gg, Gg, Gg, Gg, Gg
Gg, Gg, Gg, Gg, Gg, Gg, Gg, Gg, Gg, Gg, Gg, Gg, Gg, Gg, Gg, Gg, Mm, Khr, Mm, Mm, Mm, Mm, Hh^Fms, Gs^Fp, Gs^Fp, Gs^Fp, Gs^Fp, Gg^Fet, Gs^Fp, Gs^Fp, Gg^Efm, Gg^Efm, Gs^Fp, Gg^Fet, Gs^Fp, Gg^Fet, Gs^Fp, Gs^Fp, Gs^Fp, Hh^Fp, Re, Gs^Fp, Gs^Fp, Gs^Fms, Gs^Fp, Hh^Fp, Gg^Efm, Gs^Fp, Gs^Fp, Gs^Fp, Gg, Gg, Gg, Gg, Gg, Gg, Gg, Gg, Gg, Gg
Gg, Gg, Gg, Gg, Gg, Gg, Gg, Gg, Gg, Gg, Gg, Gg, Gg, Gg, Gg, Gg, Mm, Mm, Mm, Mm, Mm, Hh^Fp, Hh^Fms, Gs^Fp, Gs^Fp, Gs^Fp, Gs^Fp, Gs^Fp, Gs^Fp, Gs^Fp, Gs^Fp, Gs^Fp, Gs^Fms, Gs^Fp, Gs^Fp, Gs^Fp, Gs^Fp, Gs^Fp, 2 Ke, Re, Gs^Fms, Gs^Fds, Gs^Fp, Gs^Fms, Gs^Fp, Gs^Fp, Gs^Fp, Gs^Fp, Gs^Fp, Gs^Fp, Gg, Gg, Gg, Gg, Gg, Gg, Gg, Gg, Gg, Gg
Gg, Gg, Gg, Gg, Gg, Gg, Gg, Gg, Gg, Gg, Gg, Gg, Gg, Gg, Gg, Gg, Mm, Mm, Hh^Vhh, Mm, Mm, Hh^Fp, Hh^Fp, Hh^Fds, Gs^Fp, Gs^Fp, Gs^Fms, Gs^Fms, Gs^Fp, Gs^Fp, Gs^Fms, Gs^Fp, Gs^Fp, Gs^Fp, Hh^Fp, Gg^Ve, Gs^Fp, Ce, Ce, Ce, Gs^Fp, Gs^Fp, Gs^Fms, Gs^Fp, Gs^Fms, Gg^Ve, Hh^Fp, Gs^Fp, Gs^Fds, Gs^Fp, Gg, Gg, Gg, Gg, Gg, Gg, Gg, Gg, Gg, Gg
Gg, Gg, Gg, Gg, Gg, Gg, Gg, Gg, Gg, Gg, Gg, Gg, Gg, Gg, Gg, Gg, Mm, Mm, Mm, Mm, Mm, Mm, Mm, Hh^Fp, Hh^Fds, Gs^Fp, Gs^Fp, Gs^Fp, Gs^Fp, Gg^Ve, Gs^Fms, Gs^Fms, Gg^Fet, Gs^Fms, Hh^Fp, Gs^Fp, Gs^Fp, Ce, Gs^Fp, Ce, Gs^Fp, Gs^Fp, Gs^Fp, Gs^Fds, Gs^Fp, Gs^Fms, Hh^Fp, Gs^Fp, Gs^Fms, Gs^Fp, Gg, Gg, Gg, Gg, Gg, Gg, Gg, Gg, Gg, Gg
Gg, Gg, Gg, Gg, Gg, Gg, Gg, Gg, Gg, Gg, Gg, Gg, Gg, Gg, Gg, Gg, Mm, Mm, Mm, Mm, Mm, Mm, Mm, Mm, Hh^Fp, Gs^Fp, Gs^Fp, Gs^Fp, Gs^Fp, Gs^Fp, Gs^Fp, Gs^Fp, Gs^Fp, Gs^Fp, Gs^Fp, Gs^Fp, Gs^Fp, Gs^Fds, Gs^Fp, Gs^Fp, Gs^Fp, Gs^Fp, Gg^Fet, Gs^Fp, Gs^Fp, Gs^Fp, Hh^Fp, Gs^Fms, Gs^Fp, Gs^Fp, Gg, Gg, Gg, Gg, Gg, Gg, Gg, Gg, Gg, Gg
Gg, Gg, Gg, Gg, Gg, Gg, Gg, Gg, Gg, Gg, Gg, Gg, Gg, Gg, Gg, Gg, Hh, Hh, Hh, Mm, Mm, Mm, Mm, Mm, Mm, Hh^Fp, Hh^Fp, Hh^Fp, Hh^Fp, Gs^Fp, Gs^Fp, Gs^Fp, Hh^Fds, Gs^Fms, Gs^Fp, Gg^Efm, Gs^Fp, Gs^Fp, Gs^Fms, Gs^Fp, Gs^Fp, Gs^Fp, Gs^Fp, Gs^Fp, Gs^Fms, Hh^Fp, Gs^Fms, Gs^Fds, Gg^Efm, Gs^Fp, Gg, Gg, Gg, Gg, Gg, Gg, Gg, Gg, Gg, Gg
Gg, Gg, Gg, Gg, Gg, Gg, Gg, Gg, Gg, Gg, Gg, Gg, Gg, Gg, Gg, Gg, Gs, Gs, Hh, Gg, Mm, Mm, Mm, Mm, Mm, Gg, Gs^Fp, Hh^Fp, Gs^Fp, Gs^Fp, Hh^Fp, Gs^Fp, Hh^Fds, Gs^Fp, Gs^Fp, Gs^Fp, Gs^Fp, Gs^Fp, Gs^Fp, Gs^Fp, Gg^Efm, Gs^Fp, Gs^Fp, Gs^Fp, Gs^Fp, Gs^Fp, Gg^Fet, Gs^Fms, Gs^Fp, Gs^Fp, Gg, Gg, Gg, Gg, Gg, Gg, Gg, Gg, Gg, Gg
Gg, Gg, Gg, Gg, Gg, Gg, Gg, Gg, Gg, Gg, Gg, Gg, Gg, Gg, Gg, Gg, Gs, Gg, Gs, Gs, Hh, Hh, Hh^Vhh, Mm, Mm, Hh^Fp, Gg, Gs^Fp, Gs^Fp, Gs^Fp, Hh^Fp, Hh^Fms, Hh^Fp, Gs^Fms, Gs^Fms, Gg^Fet, Gg^Fet, Gs^Fp, Gs^Fms, Gs^Fp, Gll^Fp, Gs^Fp, Gs^Fp, Gs^Fms, Gs^Fp, Gs^Fp, Gs^Fp, Gs^Fms, Gs^Fp, Gg^Ve, Gg, Gg, Gg, Gg, Gg, Gg, Gg, Gg, Gg, Gg
Gg, Gg, Gg, Gg, Gg, Gg, Gg, Gg, Gg, Gg, Gg, Gg, Gg, Gg, Gg, Gg, Gs, Gs, Gs, Gg, Gs, Gs, Hh, Mm, Hh^Fp, Gg, Gg, Gg, Gg, Gs^Fp, Gs^Fp, Hh^Fms, Gs^Fp, Gs^Fp, Gs^Fms, Gs^Fp, Gs^Fp, Gs^Fp, Gs^Fms, Gs^Fp, Gll^Fp, Gs^Fms, Gg, Gs^Fms, Gs^Fp, Gs^Fp, Gg^Efm, Gs^Fp, Gg^Fet, Gs^Fp, Gg, Gg, Gg, Gg, Gg, Gg, Gg, Gg, Gg, Gg
Gg, Gg, Gg, Gg, Gg, Gg, Gg, Gg, Gg, Gg, Gg, Gg, Gg, Gg, Gg, Gg, Gs, Gs, Gg, Gg, Hh, Gs, Gs, Hh, Gg, Gg, Gg, Gs^Fms, Gg, Gg^Efm, Gs^Fp, Gs^Fp, Gs^Fp, Hh^Fms, Gs^Fp, Gs^Fp, Gs^Fp, Gs^Fp, Gs^Fms, Gs^Fds, Gs^Fp, Gll^Fp, Gs^Fp, Gs^Fms, Gs^Fp, Gs^Fp, Gs^Fp, Gs^Fms, Gs^Fp, Gs^Fms, Gg, Gg, Gg, Gg, Gg, Gg, Gg, Gg, Gg, Gg
Gg, Gg, Gg, Gg, Gg, Gg, Gg, Gg, Gg, Gg, Gg, Gg, Gg, Gg, Gg, Gg, Gs, Gs, Gg, Gg, Mm, Hh^Fp, Hh^Fms, Gg, Gg, Gs^Fms, Gg, Gg, Gg, Gg, Gs^Fp, Gs^Fp, Hh^Fms, Hh^Fms, Gs^Fp, Gs^Fms, Gs^Fp, Gg^Fet, Gg^Ve, Gs^Fp, Gs^Fp, Gs^Fp, Gs^Fp, Gs^Fp, Gs^Fp, Gs^Fp, Gs^Fms, Gg^Efm, Gg^Efm, Gs^Fp, Gg, Gg, Gg, Gg, Gg, Gg, Gg, Gg, Gg, Gg
Gg, Gg, Gg, Gg, Gg, Gg, Gg, Gg, Gg, Gg, Gg, Gg, Gg, Gg, Gg, Gg, Gs, Hh, Mm, Mm, Mm, Mm, Gg, Gg, Gg, Gg, Gg, Gs^Fms, Gg, Gg, Gg, Hh^Fms, Gs^Fp, Gs^Fp, Gs^Fp, Gs^Fp, Gs^Fp, Gs^Fp, Gs^Fp, Gs^Fms, Gs^Fp, Gs^Fp, Gs^Fp, Gs^Fms, Gs^Fp, Gs^Fds, Gs^Fds, Gs^Fds, Gs^Fp, Gg^Efm, Gg, Gg, Gg, Gg, Gg, Gg, Gg, Gg, Gg, Gg
Gg, Gg, Gg, Gg, Gg, Gg, Gg, Gg, Gg, Gg, Gg, Gg, Gg, Gg, Gg, Gg, Hh, Hh, Mm, Mm, Hh^Vhh, Hh^Fp, Gg, Gg, Gg, Gg, Gg, Gg, Gs^Fp, Gs^Fp, Gg, Hh^Fms, Gs^Fp, Gs^Fp, Gg^Fet, Gs^Fp, Gs^Fms, Gs^Fp, Gs^Fp, Gs^Fms, Gs^Fms, Gs^Fp, Gg^Fet, Gs^Fms, Gs^Fp, Gg^Fet, Gs^Fms, Gs^Fp, Hh^Fp, Hh^Fp, Gg, Gg, Gg, Gg, Gg, Gg, Gg, Gg, Gg, Gg
Gg, Gg, Gg, Gg, Gg, Gg, Gg, Gg, Gg, Gg, Gg, Gg, Gg, Gg, Gg, Gg, Mm, Mm, Mm, Mm, Hh, Gg, Hh, Hh^Fp, Hh^Fp, Gg, Hh^Fp, Gg, Gg, Hh^Fms, Gg, Gg, Gs^Fp, Gs^Fp, Gs^Fp, Gs^Fp, Gg^Efm, Gg^Efm, Gs^Fp, Gs^Fp, Gs^Fms, Gs^Fp, Gs^Fds, Gg^Fet, Gs^Fp, Gs^Fp, Gs^Fms, Gll^Fp, Gs^Fms, Hh^Fp, Gg, Gg, Gg, Gg, Gg, Gg, Gg, Gg, Gg, Gg
Gg, Gg, Gg, Gg, Gg, Gg, Gg, Gg, Gg, Gg, Gg, Gg, Gg, Gg, Gg, Gg, Mm, Mm, Mm, Mm, Gg, Gg, Hh, Hh^Fms, Hh, Hh, Hh, Gg, Gg, Gg, Gg, Gg, Gg, Gs^Fp, Gs^Fp, Gs^Fp, Gs^Fp, Gs^Fp, Gs^Fp, Gs^Fp, Gs^Fp, Gs^Fms, Gs^Fms, Gs^Fp, Gs^Fp, Gs^Fp, Hh^Fp, Gg, Mm, Mm, Gg, Gg, Gg, Gg, Gg, Gg, Gg, Gg, Gg, Gg
Gg, Gg, Gg, Gg, Gg, Gg, Gg, Gg, Gg, Gg, Gg, Gg, Gg, Gg, Gg, Gg, Mm, Mm, Mm, Mm, Gg, Gg, Gg, Hh, Hh, Hh, Hh, Gg, Gg, Gg, Gs^Fp, Gg, Gg, Gs^Fp, Gs^Fp, Gs^Fp, Gs^Fp, Gs^Fp, Gs^Fp, Gs^Fp, Gg^Fet, Gg^Fet, Gs^Fp, Gs^Fms, Gs^Fp, Gs^Fp, Hh^Fp, Hh^Fp, Mm, Mm^Xm, Gg, Gg, Gg, Gg, Gg, Gg, Gg, Gg, Gg, Gg
Gg, Gg, Gg, Gg, Gg, Gg, Gg, Gg, Gg, Gg, Gg, Gg, Gg, Gg, Gg, Gg, Mm, Mm, Mm, Hh^Fms, Hh^Fp, Gg, Gg, Gg, Hh, Hh^Fp, Hh^Fms, Gg, Gg, Gg, Gg, Gg, Gg, Gg, Gs^Fp, Gs^Fp, Gs^Fms, Hh^Fms, Hh^Fms, Gs^Fp, Gs^Fms, Gs^Fp, Gs^Fms, Gs^Fms, Hh^Fp, Gs^Fp, Hh^Fp, Mm, Mm^Xm, Mm^Xm, Gg, Gg, Gg, Gg, Gg, Gg, Gg, Gg, Gg, Gg
Gg, Gg, Gg, Gg, Gg, Gg, Gg, Gg, Gg, Gg, Gg, Gg, Gg, Gg, Gg, Gg, Ms, Ms, Mm, Hh^Fp, Gg, Hh, Hh, Gg, Hh, Hh, Hh^Fp, Gg, Gg, Gg, Gg, Gg, Gg, Gg, Gg, Gs^Fp, Gs^Fp, Gs^Fp, Gs^Fp, Gs^Fms, Gs^Fp, Gs^Fms, Gs^Fp, Gg^Ve, Gs^Fp, Hh^Fp, Hh^Fp, Mm^Xm, Mm, Mm, Gg, Gg, Gg, Gg, Gg, Gg, Gg, Gg, Gg, Gg
Mm, Gg, Gg, Gg, Gg, Gg, Gg, Gg, Gg, Gg, Gg, Gg, Gg, Gg, Mm, Gg, Ms, Mm, Mm, Hh, Hh^Fp, Hh, Gg, Hh, Mm, Mm, Mm, Hh^Fp, Gg, Gg, Gg, Gg, Gg, Gg, Gs, Gg, Gg, Gs^Fp, Gg, Gs^Fp, Gg^Efm, Gs^Fp, Hh^Fms, Gs^Fds, Gs^Fds, Hh^Fp, Mm^Xm, Mm^Xm, Mm, Gs^Fp, Gg, Gg, Gg, Gg, Gg, Gg, Gg, Gg, Gg, Gg
Mm, Mm, Gg, Gg, Gg, Gg, Gg, Gg, Gg, Gg, Mm, Gg, Mm, Mm, Mm, Mm, Mm, Mm, Hh, Mm, Hh^Fp, Gg, Gg, Hh^Vhh, Mm, Mm, Mm, Gg, Gg, Gg, Gg, Gg, Gs, Gg, Gg, Gg, Gg, Gg, Gg, Gg, Gg, Gs^Fp, Gs^Fp, Gs^Fp, Gs^Fds, Hh^Fp, Mm^Xm, Mm, Gg, Gg, Gg, Gg, Gg, Gg, Gg, Gg, Gg, Gg, Gg, Gg
Gg, Mm, Mm, Mm, Mm, Gg, Gg, Gg, Mm, Mm, Gg, Mm, Ms, Ms, Mm, Gg, Mm, Mm, Gg, Hh, Gg, Gg, Hh, Hh^Fp, Hh^Fms, Mm, Gg, Gg, Gs, Gg, Gg, Gg, Gs, Gg, Gs, Gs, Gs^Fp, Gg, Gg, Gg, Gs, Gg, Gg, Gs^Fp, Gs^Fp, Hh^Fp, Mm^Xm, Mm, Gg, Gg, Gg, Gg, Gg, Gg, Gg, Gg, Gg, Gg, Gg, Gg
Hh, Hh, Hh, Hh, Hh, Mm, Mm, Mm, Gg, Mm, Mm, Gg, Mm, Mm, Mm, Gg, Mm, Mm, Hh, Gg, Hh, Hh, Mm, Hh, Hh, Hh, Gs, Gs, Gs, Gg, Hh^Fp, Gg, Gs^Fp, Gs, Gg, Gg, Hh^Fp, Gs^Fp, Gs^Fp, Gg, Gg, Gg, Hh^Fp, Hh^Fp, Ha^Fma, Mm^Xm, Mm, Mm, Gs^Fp, Mm, Gg, Gg, Gg, Gg, Gg, Gg, Gg, Gg, Gg, Gg
Hh, Gg, Hh, Hh, Gg, Mm, Mm, Gg, Mm, Mm, Mm, Ms, Ms, Ms, Mm, Mm, Hh, Hh^Vhh, Hh, Hh, Gg, Mm, Hh^Fp, Hh, Hh, Gg, Gs, Gs, Gs, Gg, Gs^Fp, Hh^Fp, Gg, Gg, Gg, Gg, Gs^Fp, Gs, Gg, Gg, Gs^Fp, Gg, Hh^Fp, Ms, Mm^Xm, Mm^Xm, Mm, Gg, Mm, Mm, Gg, Gg, Gg, Gg, Gg, Gg, Gg, Gg, Gg, Gg
Gg, Gg, Gg, Hh, Gg, Hh, Gg, Mm, Mm, Mm, Wo, Ms, Mm, Mm, Mm, Mm, Mm, Hh, Hh^Fp, Mm, Mm, Mm, Mm, Hh, Gs, Gs, Gg, Gg, Gs, Gg, Gg, Gg, Gg, Gg, Gg, Gs^Fp, Hh^Fp, Gg, Gs^Fp, Gs^Fp, Gg, Hh^Fp, Mm^Xm, Mm^Xm, Mm, Mm, Hh^Fms, Gg, Mm, Mm^Xm, Gg, Gg, Gg, Gg, Gg, Gg, Gg, Gg, Gg, Gg
Gg, Gg, Gg, Hh, Gg, Hh, Hh, Hh, Hh, Ww, Hh, Mm, Mm, Mm, Mm, Mm, Hh, Hh^Fp, Hh^Fms, Hh^Fms, Hh, Hh, Hh, Hh, Gg, Gg, Gs, Gg, Gg, Gg, Gg, Gs^Fp, Hh^Fp, Gg^Vc, Hh, Hh^Fp, Hh^Fmw, Gs^Fp, Gs, Gg, Gg, Hh^Fp, Mm^Xm, Mm, Gs^Fp, Gs^Fp, Gg^Efm, Mm, Mm, Mm^Xm, Gg, Gg, Gg, Gg, Gg, Gg, Gg, Gg, Gg, Gg
Gg, Ss, Ss, Gg, Gg, Hh, Gg, Gg, Hh, Wo, Hh, Mm, Mm, Gg, Mm, Mm, Hh, Mm, Hh, Mm, Hh, Hh, Gg, Gg^Efm, Gs, Gg, Hh^Fp, Gs^Fp, Gg^Efm, Gg, Gg, Hh, Hh, Hh, Ms, Mm, Hh, Gs, Gg, Gg, Gg, Gg, Mm^Xm, Mm, Mm, Gg, Gg, Gg, Gg, Gg, Gg, Gg, Gg, Gg, Gg, Gg, Gg, Gg, Gg, Gg
Gg, Ss, Gg, Ss, Gg, Ss, Gg, Gg, Gg, Ww, Gg, Hh, Gg, Gg, Mm, Mm, Hh, Hh^Fp, Hh^Fms, Hh, Gg, Gg, Gg, Gg, Gg, Gs, Gg, Gg, Gg, Gg, Gg^Efm, Gg, Hh^Fp, Mm, Mm^Xm, Mm, Hh^Vhh, Gg, Gs, Gg, Hh, Mm, Mm, Mm^Xm, Mm^Xm, Gg, Gg, Gg, Gg, Gg, Gg, Gg, Gg, Gg, Gg, Gg, Gg, Gg, Gg, Gg
Ww, Gg, Gg, Gg, Ss, Ss, Gg, Ss, Wo, Ww, Gg, Hh, Hh, Hh, Mm, Mm, Gg, Hh, Hh, Hh^Fp, Hh^Fms, Gg, Hh^Fms, Hh, Hh, Hh, Gg^Efm, Gg, Gg, Hh, Hh, Hh, Mm, Mm^Xm, Mm, Gg, Gs, Gg, Gs, Gg, Hh, Hh^Fp, Mm, Mm, Mm^Xm, Gg, Gg, Gg, Gg, Gg, Gg, Gg, Gg, Gg, Gg, Gg, Gg, Gg, Gg, Gg
Ww, Wo, Ww, Ss^Vhs, Ss, Ss, Gg, Gg, Wo, Ss, Gg, Gg, Hh, Hh, Hh, Mm, Mm, Mm, Mm, Gg, Hh, Hh^Fms, Mm, Hh, Gg, Gs, Gg, Gs, Gg, Gg, Gg^Efm, Mm, Mm^Xm, Mm^Xm, Hh^Fms, Hh, Hh, Gg, Gg, Gg, Hh, Hh^Fdw, Mm, Mm, Mm^Xm, Gg, Gg, Gg, Gg, Gg, Gg, Gg, Gg, Gg, Gg, Gg, Gg, Gg, Gg, Gg
Ww, Gg, Ww, Gg, Ss, Ss, Ss, Ss, Ww, Ss, Ss, Gg, Gg, Gg, Hh, Hh, Gg, Mm, Hh, Hh, Mm, Mm, Hh, Hh, Ke, Gg, Gg, Gs, Gg, Hh, Mm, Mm, Mm^Xm, Mm, Hh^Fdw, Hh, Gg, Gg^Efm, Gg, Gg^Efm, Mm, Gg, Mm^Xm, Mm^Xm, Hh^Fp, Gg, Gg, Gg, Gg, Gg, Gg, Gg, Gg, Gg, Gg, Gg, Gg, Gg, Gg, Gg
Wo, Ww, Ww, Ss, Gg, Ss, Ss, Ss, Ss, Ww, Gs^Vc, Ss, Ss, Gg, Gg, Gg, Hh, Hh, Hh^Fms, Mm, Hh, Mm, Gg, Ce, Ce, Ce, Gg^Efm, Gg, Hh, Hh, Mm, Ms, Ms, Mm^Xm, Mm, Gg, Gs, Gg, Gg, Hh, Ha^Vhha, Mm^Xm, Mm, Mm, Mm^Vc, Gg, Gg, Gg, Gg, Gg, Gg, Gg, Gg, Gg, Gg, Gg, Gg, Gg, Gg, Gg
Wo, Wo, Gg, Ww, Ww, Gg, Ss, Sm, Wo, Ww, Ss, Gg, Gg, Gg, Ss, Ss, Ss, Gg, Gg, Gg, Gg, Hh, Gg, Gg, Gg, Gg, Gg, Gg, Hh^Vhh, Mm, Ww, Ms, Mm, Mm^Xm, Mm, Hh, Gs, Gg, Gg, Hh, Mm, Mm^Xm, Mm^Xm, Mm, Hh, Gg, Gg, Gg, Gg, Gg, Gg, Gg, Gg, Gg, Gg, Gg, Gg, Gg, Gg, Gg
Ww, Ww, Ww, Ww, Wo, Ww, Wo, Ss, Ww, Ww, Ww, Ss, Ss, Ss, Ss, Gg, Gg, Ss, Ss, Gg, Ss, Gg^Efm, Gg, Gg, Gg, Gg, Gg, Gg, Gg, Gg, Ww, Mm, Mm, Mm^Xm, Mm^Xm, Mm, Hh, Gg, Gg, Gg, Mm, Mm, Mm^Xm, Mm, Hh, Gg, Gg, Gg, Gg, Gg, Gg, Gg, Gg, Gg, Gg, Gg, Gg, Gg, Gg, Gg
Gg, Ww, Gg, Gs, Gg, Wo, Ww, Ww, Gg, Ss, Ss, Ss, Ss, Ww, Ss, Ss, Gg, Gg, Gg, Gg, Gg, Gg, Gg, Ss, Gg, Ss, Gg, Gg, Gg, Gg, Wwf, Hh^Fmw, Gg, Mm, Mm, Mm^Xm, Mm, Gg, Gg, Gg, Mm, Mm^Xm, Mm, Hh, Hh, Gg, Gg, Gg, Gg, Gg, Gg, Gg, Gg, Gg, Gg, Gg, Gg, Gg, Gg, Gg
Gg, Ss, Gg, Gg, Gg, Ss, Ww, Ww, Gg, Gg, Ss, Gg, Ww, Wo, Ww, Gg, Ss, Ss, Ss, Ss, Ss, Ss, Gg, Ss, Ss, Gg, Ss, Ss, Wo, Ww, Gg^Efm, Gg, Gg, Hh^Fmw, Mm, Mm^Xm, Mm^Xm, Mm, Mm, Gg, Mm, Mm^Xm, Mm, Gs^Fp, Hh^Fmw, Gg, Gg, Gg, Gg, Gg, Gg, Gg, Gg, Gg, Gg, Gg, Gg, Gg, Gg, Gg
Gg, Gg, Ss, Ss, Gg, Ss^Vhs, Ww, Wo, Ww, Ss, Ss^Vhs, Ss, Ss, Wo, Ww, Ss, Ss, Gg, Gg^Efm, Gg^Efm, Ss, Ss, Ss, Gg, Ss, Ds, Ww, Wo, Ss, Ss, Ww, Gg^Efm, Gg, Hh, Gg^Efm, Mm, Ha, Mm^Xm, Mm, Hh, Hh, Mm^Xm, Mm, Gg, Hh^Fmw, Gg, Gg, Gg, Gg, Gg, Gg, Gg, Gg, Gg, Gg, Gg, Gg, Gg, Gg, Gg
Gg, Gg, Gg, Ss, Gg, Ss, Ss, Wo, Wo, Ww, Ss, Ss, Wwf, Ww, Ss, Gg, Ss, Gg, Ss, Ss^Vhs, Ss, Gg^Efm, Gg, Ss, Gg, Ww, Ww, Ss, Ss, Ss, Ss, Gg^Efm, Gg, Gg, Wwf, Ww, Hh, Mm^Xm, Mm, Hh, Hh, Mm^Xm, Mm, Gg, Gg, Gg, Gg, Gg, Gg, Gg, Gg, Gg, Gg, Gg, Gg, Gg, Gg, Gg, Gg, Gg
Gg, Ss, Ss, Gg, Gg, Gg, Gg, Gg, Ww, Ww, Wo, Sm, Ss, Ss, Ss, Sm, Ss, Ss, Gg, Ss, Ss, Gg, Gg, Gg, Ss, Ww, Ww, Ss, Ss, Ss, Ss, Gg, Ww, Ww, Gs^Fp, Gs^Fp, Chr, Mm, Hh^Fp, Mm, Mm^Xm, Mm^Xm, Mm, Gg^Efm, Mm, Gg, Gg, Gg, Gg, Gg, Gg, Gg, Gg, Gg, Gg, Gg, Gg, Gg, Gg, Gg
Gg, Gg, Ss, Gg, Ss, Gg, Ss, Ss, Ss, Ww, Ww, Ss, Gg, Ww, Ss, Ww, Ss, Ss, Gg, Gg, Ss, Ss, Gg^Efm, Ss, Ss, Ww, Ss, Ss, Ss, Ss, Ww, Ww, Ss, Ww, Gg, Gs^Fp, Chr, Khr, Mm^Vhh, Mm, Mm^Xm, Mm, Mm, Hh, Ms, Gg, Gg, Gg, Gg, Gg, Gg, Gg, Gg, Gg, Gg, Gg, Gg, Gg, Gg, Gg
Hh, Gg, Ss, Ss, Gg, Ss, Sm, Ss, Ss, Ww, Ss, Ww, Ss, Gg, Gg, Gg, Gg, Ss, Ww, Ss, Gg^Efm, Ss, Ss, Ss, Wo, Ww, Gg, Gg, Gg, Ss, Ww, Ww, Ss, Gg, Rb, Gs, Hh, Chr, Hh^Fmw, Mm, Mm, Mm^Xm, Mm^Xm, Mm, Mm, Gg, Gg, Gg, Gg, Gg, Gg, Gg, Gg, Gg, Gg, Gg, Gg, Gg, Gg, Gg
Gg, Ss, Gg, Hh, Ss, Ss, Ss, Gg, Gg, Ww, Ss, Wo, Ss, Ss, Ss, Gg, Ss, Gg, Ss, Ss, Khs, Ss, Ds, Wo, Ww, Ss, Ss^Vhs, Gg^Efm, Gg, Ds, Wo, Ss, Ss, Gg, Rb, Hh^Fp, Hh^Fms, Gg, Hh^Fmw, Mm, Mm, Mm^Xm, Mm, Mm, Mm, Gg, Gg, Gg, Gg, Gg, Gg, Gg, Gg, Gg, Gg, Gg, Gg, Gg, Gg, Gg
Rb, Rb, Rb, Rb, Rb, Gg, Hh, Ss, Gg, Wo, Wo, Ww, Wo, Ss, Ss^Vhs, Gg, Ss, Ss, Ss, Ss, Chs, Ss, Wo, Wo, Ss, Ss, Ss, Ss, Ss, Ds, Ww, Ss, Rb, Rb, Gg, Gg, Gg, Gg^Efm, Mm^Vhh, Hh, Mm^Xm, Mm^Xm, Mm, Mm, Mm, Gg, Gg, Gg, Gg, Gg, Gg, Gg, Gg, Gg, Gg, Gg, Gg, Gg, Gg, Gg
Hh, Ss, Hh, Gg, Hh, Rb, Rb, Gg, Ss, Ss, Ww, Ww, Ww, Wo, Ss, Gg, Gg, Ss, Ss, Ss, Chs, Chs, Ww, Ww, Rb, Rb, Rb, Rb, Rb, Re, Ww, Rb, Gg^Efm, Ss, Ss, Gg, Gg^Efm, Hh, Hh, Hh, Mm, Mm^Xm, Mm^Xm, Mm, Hh^Fms, Gg, Gg, Gg, Gg, Gg, Gg, Gg, Gg, Gg, Gg, Gg, Gg, Gg, Gg, Gg
Hh, Hh, Gs, Gg, Hh, Ch, Gg, Rb, Gg, Ss, Ss, Ss, Wo, Ww, Ww, Ss, Ss, Ss, Gg, Gg^Efm, Gg, Ss, Rb, Ww, Ss, Ss, Ss, Ss, Ss, Ss, Ww, Gg, Gg^Efm, Gg, Gg, Gg^Efm, Hh^Fms, Gg^Efm, Gg^Efm, Hh, Mm, Mm, Mm, Mm, Ke, Gg, Gg, Gg, Gg, Gg, Gg, Gg, Gg, Gg, Gg, Gg, Gg, Gg, Gg, Gg
Gg, Gg, Gg, Hh, Hh, Ch, Hh, Rb, Gg, Ss, Gg, Gg, Ww, Gg, Ww, Gg, Ss, Ss, Ss, Ss, Rb, Rb, Gg, Ww, Ww, Ss, Ss, Ds, Ds, Ss, Ww, Ww, Ds, Ds, Ss, Hh, Gg, Gg, Gg, Hh, Hh, Mm, Mm, Mm, Ce, Gg, Gg, Gg, Gg, Gg, Gg, Gg, Gg, Gg, Gg, Gg, Gg, Gg, Gg, Gg
Mm, Mm, Hh, Hh^Vhh, Mm, Kh, Ch, Re, Rb, Gg, Wo, Ww, Gg, Ww, Ww, Gg, Ss, Ss, Rb, Rb, Ss, Gg^Efm, Ds, Ds, Ww, Ss, Wo, Wo, Ww, Ww, Ww, Ww, Gg, Gg, Gg, Hh, Gg, Gg, Gg^Efm, Gg^Efm, Hh, Hh^Fds, Mm, Mm, Gg, Gg, Gg, Gg, Gg, Gg, Gg, Gg, Gg, Gg, Gg, Gg, Gg, Gg, Gg, Gg
Wo, Mm, Wo, Mm, Mm, Gs, Ds, Gg, Gg, Ww^Bw\, Rb, Gg, Gg, Ww, Ww, Wo, Rb, Rb, Ss^Vhs, Ss, Ss, Ss, Ds, Ds, Ww, Ww, Ww, Ww, Ss, Ww, Ds, Ds, Ww, Ww, Gg, Gg, Gg, Gg, Wo, Gg^Efm, Gg, Hh^Fds, Hh, Mm, Gg, Gg, Gg, Gg, Gg, Gg, Gg, Gg, Gg, Gg, Gg, Gg, Gg, Gg, Gg, Gg
Ww, Ww, Ww, Wo, Wwr, Wwf, Ww, Ww, Ww, Ww, Gs, Re, Re, Gs, Wwf, Wwf, Ss, Ss, Ss, Ss, Gg, Gg, Ww, Ww, Ww, Ww, Ww, Ww, Ss, Gg^Efm, Ww, Ww, Wo, Ww, Ww, Gg, Ww, Ds, Gg^Efm, Gs^Vht, Gg, Gg, Gg, Hh, Ds, Ds, Wo, Gg, Gg, Gg, Gg, Gg, Gg, Gg, Gg, Gg, Gg, Gg, Gg, Gg
Ww, Ww, Wo, Wo, Wwf, Ww, Wo, Ww, Wwf, Ww, Ds, Gs, Gs, Re, Wo^Bw\, Ww, Ww, Ss, Ss, Ds, Ww, Ww, Wo, Wo, Ww, Ds, Ww, Ss^Vm, Ww, Ww, Wo, Ww, Wo, Wo, Wo, Ww, Wo, Ww, Ww, Ds, Ds, Ds, Ww, Ww, Wo, Ww, Ww, Wo, Gg, Gg, Gg, Gg, Gg, Gg, Gg, Gg, Gg, Gg, Gg, Gg
Wo, Ww, Ww, Ww, Ww, Wwr, Wo, Ww, Wwr, Ww, Ww, Ds, Wo, Ds, Ww, Wo, Wo, Ss, Ww, Ww, Ww, Ww, Wo, Ww, Ww, Ww, Ww, Ww, Ww, Wo, Wo, Wo, Wo, Wo, Wo, Wo, Wo, Wo, Wo, Ww, Wwr, Ww, Ww, Ww, Wo, Wo, Wo, Ww, Gg, Gg, Gg, Gg, Gg, Gg, Gg, Gg, Gg, Gg, Gg, Gg
Ww, Wo, Wo, Wo, Wo, Wwf, Wwr, Wo, Wo, Ww, Wo, Wo, Wo, Ww, Wo, Wo, Ww, Ww, Wo, Wo, Wo, Wo, Wo, Wo, Ww, Wo, Ww, Ww, Wwr, Ww, Wo, Wo, Wo, Wo, Ww, Wo, Ww, Wo, Wo, Ww, Wwr, Ww, Wo, Ww, Wo, Wo, Wo, Ww, Wo, Gg, Gg, Gg, Gg, Gg, Gg, Gg, Gg, Gg, Gg, Gg
Wo, Wo, Wo, Wo, Wwr, Wo, Wwr, Ww, Ww, Wo, Wwr, Ww, Wo, Wo, Wo, Ww, Wo, Ww, Wo, Wo, Wo, Wo, Wo, Ww, Ds, Ww, Ww, Wo, Ww, Wo, Wo, Wo, Wo, Wo, Wo, Wo, Wo, Wo, Wo, Wo, Wo, Wo, Wo, Wo, Wwr, Wo, Wo, Wo, Wo, Gg, Gg, Gg, Gg, Gg, Gg, Gg, Gg, Gg, Gg, Gg
Wo, Wo, Wo, Hh, Wwr, Wo, Wo, Wo, Wo, Wo, Wo, Wwf, Wo, Wo, Wo, Ww, Wo, Wo, Wo, Wo, Wo, Wo, Wwr, Ww, Gs, Ww, Wo, Ww, Wo, Wo, Wo, Wo, Wo, Wo, Wo, Wo, Wo, Wo, Wo, Wo, Wo, Wo, Ww, Wwr, Wo, Wo, Wo, Wo, Wo, Gg, Gg, Gg, Gg, Gg, Gg, Gg, Gg, Gg, Gg, Gg
Wo, Wo, Wo, Gs, Gs^Vc, Wo, Wo, Wo, Wo, Wo, Wo, Wo, Wo, Wo, Wo, Wo, Wo, Wo, Wo, Wo, Wo, Wo, Wwr, Ww, Wo, Wo, Wwr, Wo, Wo, Wo, Wo, Wo, Wo, Wo, Wo, Wo, Wo, Wo, Wo, Wo, Gg, Ww, Wo, Wo, Wo, Wo, Wo, Wo, Wo, Gg, Gg, Gg, Gg, Gg, Gg, Gg, Gg, Gg, Gg, Gg
Ww, Wo, Ww, Ds, Gs, Wo^Bw\, Wo, Wo, Wo, Wo, Wo, Wo, Wo, Wo, Wo, Wo, Wo, Wo, Wo, Wo, Wo, Wo, Wwr, Ww, Ww, Ww, Wo, Wo, Wo, Wo, Wo, Wo, Wo, Wo, Wo, Wo, Wo, Wo, Hh, Gg, Hh, Gg, Ds, Wo, Wo, Wo, Wo, Wo, Wo, Gg, Gg, Gg, Gg, Gg, Gg, Gg, Gg, Gg, Gg, Gg
