border_size=1
usage=map

Uu, Uu, Uu, Uu, Uu, Uu, Uu, Uu, Uu, Uu, Uu, Uu, Uu, Uu, Uu, Uu, Uu, Uu, Uu, Uu, Uu, Uu, Uu, Uu, Uu, Uu, Uu, Uu, Uu, Uu, Uu, Uu, Uu, Uu, Uu, Uu, Uu, Uu, Uu, Uu, Uu, Uu, Uu, Uu, Uu, Uu, Uu, Uu, Uu, Uu, Uu, Uu, Uu, Uu, Uu, Uu, Uu, Uu, Uu, Uu, Uu, Uu, Uu, Uu, Uu, Uu, Uu, Uu, Uu, Uu, Uu, Uu, Uu, Uu, Uu, Uu, Uu, Uu, Uu, Uu, Uu, Uu, Uu, Uu, Uu, Uu, Uu, Uu, Uu, Uu, Uu, Uu, Uu, Uu, Uu, Uu, Uu, Uu, Uu, Uu, Uu, Uu, Uu, Uu
Uu, Uu, Uu, Uu, Uu, Uu, Uu, Uu, Uu, Uu, Uu, Uu, Uu, Uu, Uu, Uu, Uu, Uu, Uu, Uu, Uu, Uu, Uu, Uu, Uu, Uu, Uu, Uu, Uu, Uu, Uu, Uu, Uu, Uu, Uu, Uu, Uu, Uu, Uu, Uu, Uu, Uu, Uu, Uu, Uu, Uu, Uu, Uu, Uu, Uu, Uu, Uu, Uu, Uu, Uu, Uu, Uu, Uu, Uu, Uu, Uu, Uu, Uu, Uu, Uu, Uu, Uu, Uu, Uu, Uu, Uu, Uu, Uu, Uu, Uu, Uu, Uu, Uu, Uu, Uu, Uu, Uu, Uu, Uu, Uu, Uu, Uu, Uu, Uu, Uu, Uu, Uu, Uu, Uu, Uu, Uu, Uu, Uu, Uu, Uu, Uu, Uu, Uu, Uu
Uu, Uu, Uu, Uu, Uu, Uu, Uu, Uu, Uu, Uu, Uu, Uu, Uu, Uu, Uu, Uu, Uu, Uu, Uu, Uu, Uu, Uu, Uu, Uu, Uu, Uu, Uu, Uu, Uu, Uu, Uu, Uu, Uu, Uu, Uu, Uu, Uu, Uu, Uu, Uu, Uu, Uu, Uu, Uu, Uu, Uu, Uu, Uu, Uu, Uu, Uu, Uu, Uu, Uu, Uu, Uu, Dd, Uu, Dd, Uu, Ds, Uu, Mm, Uu, Gd, Uu, Dd, Uu, Hd, Uu, Gd, Uu, Gd, Uu, Mm, Uu, Dd, Uu, Hhd, Uu, Dd, Uu, Hhd, Uu, Hhd, Uu, Hd, Uu, Hhd, Uu, Gs, Uu, Gd, Uu, Gd, Uu, Gd, Uu, Gd, Uu, Hh, Uu, Uu, Uu
Uu, Uu, Uu, Uu, Uu, Uu, Uu, Uu, Uu, Uu, Uu, Uu, Uu, Uu, Uu, Uu, Uu, Uu, Uu, Uu, Uu, Uu, Uu, Uu, Uu, Uu, Uu, Uu, Uu, Uu, Uu, Uu, Uu, Uu, Uu, Uu, Uu, Uu, Uu, Uu, Uu, Uu, Uu, Uu, Uu, Uu, Uu, Uu, Uu, Uu, Uu, Uu, Uu, Uu, Uu, Hd, Hd, Hd, Dd, Hd, Hd, Hd, Mm, Md, Md, Dd, Md, Gd, Mm, Hhd, Hd, Hhd, Dd, Dd, Md^Xm, Md, Hd, Hd, Hhd, Hhd, Rd, Dd, Dd^Edp, Hd, Dd, Hd, Hd, Hhd, Hhd, Md, Hhd, Hhd, Gd, Hhd, Hhd, Gd, Hhd, Gd, Gd, Hh, Gd, Uu, Uu, Uu
Uu, Uu, Uu, Uu, Uu, Uu, Uu, Uu, Uu, Uu, Uu, Uu, Uu, Uu, Uu, Uu, Uu, Uu, Uu, Uu, Uu, Uu, Uu, Uu, Uu, Uu, Uu, Uu, Uu, Uu, Uu, Uu, Uu, Uu, Uu, Uu, Uu, Uu, Uu, Uu, Uu, Uu, Uu, Uu, Uu, Uu, Uu, Uu, Uu, Uu, Uu, Uu, Uu, Uu, Uu, Dd, Dd, Dd, Dd, Dd, Dd, Hhd, Hhd, Md, Md, Hd, Md, Md, Hhd, Mm, Dd, Hhd, Mm, Md, Md, Md, Hhd, Md, Hhd, Dd, Rd^Esd, Gd, Hhd, Gd, Hhd, Dd, Dd^Edpp, Md, Gd, Gd^Vhr, Hhd, Hhd, Hhd, Gd^Es, Hhd, Hhd, Mm, Hhd, Mm, Hh, Gd, Uu, Uu, Uu
Uu, Uu, Uu, Uu, Gg, Gg, Gll^Fp, Gll, Gll, Gg, Gs, Gs, Hh^Fp, Gg, Mm, Ms, Ms^Xm, Wo, Wo, Ms, Ms, Ms, Mm, Mm, Mm, Mm, Mm, Mm, Mm, Hh, Hh, Hh, Hh, Gs, Gs, Gs, Gd, Gs, Gd, Hhd, Hhd, Hhd, Rd, Rd, Hhd, Hhd, Rd, Rd, Hd, Hhd, Rd, Dd, Hd, Dd, Dd, Hhd, Dd^Edp, Dd, Hd, Dd, Hd, Dd, Dd^Dr, Hd, Md, Mm, Hhd, Mm, Md, Mm, Md, Hhd, Hhd, Hhd, Hhd, Md, Dd, Hhd^Vhhr, Rd, Rd, Gd, Gd, Hhd, Hhd, Gd, Md, Gd, Hhd, Gd^Es, Hhd, Hhd, Hhd, Hhd, Hhd, Md, Gd^Es, Gd, Mm, Hhd, Gd, Md, Uu, Uu, Uu
Uu, Uu, Uu, Uu, Gg, Gll^Fp, Gs, Gll^Fp, Gs, Gs^Fms, Gll, Gg, Gll^Fp, Hh^Fp, Hh, Mm, Ms, Ha, Wo, Ms, Ha, Ms, Ms, Mm, Mm, Mm, Mm, Hh, Gg, Hh, Gs, Hh, Gs, Gs, Gs, Gs, Gs, Rd, Gd, Rd, Gd, Rd, Hhd, Hhd, Hhd, Hhd, Rd, Rd, Rd^Esd, Hhd, Dd^Edpp, Rd, Hd, Rd, Dd^Vdt, Rd^Dr, Dd, Dd, Hd, Hd, Dd, Hd, Hd, Hhd, Hhd, Md, Hhd, Hd, Md, Dd^Dr, Mm, Md, Gd, Hhd, Gd, Hhd, Hhd, Gd, Rd, Gd, Hd, Gd, Md, Hhd, Gd, Md, Md, Hhd, Gd, Hhd, Gd, Hhd, Hhd, Hhd, Gd, Gd, Md, Md, Md, Md, Md, Uu, Uu, Uu
Uu, Uu, Uu, Uu, Gg, Gll, Gll^Fp, Gll, Gs^Fms, Gs, Gs, Gll, Gs, Gs, Gg, Mm, Mm, Ms, Ms, Ha, Ha, Ha, Ms, Mm, Mm, Mm, Mm, Gg, Mm, Gs, Hh, Hh, Hh, Gs^Es, Gs, Gs, Gs, Gd, Hhd, Hhd, Hhd^Vhhr, Gd, Gd, Rd, Gd, Hhd, Dd, Rd^Dr, Rd, Dd, Dd, Rd, Rd, Dd, Rd, Hd, Hd, Dd, Hd, Dd, Dd, Dd, Dd^Dc, Dd, Hd, Mm, Md, Hhd, Md, Hhd, Md, Md, Gd, Hhd, Md, Gd, Hhd, Rd, Gd^Es, Gd, Hhd, Hhd, Gs, Hhd, Gd, Md, Hhd, Md, Hhd, Md, Hhd, Hhd, Hhd, Hhd, Hhd, Hh, Md, Hhd, Md, Md, Gs, Uu, Uu, Uu
Uu, Uu, Uu, Uu, Gg, Gll^Fp, Gll^Fp, Gll^Fp, Gs, Gll^Fp, Gs, Gs^Fms, Gs, Hh^Fp, Gg, Hh, Hh^Fp, Mm, Ha, Ms, Ms, Ms, Ms, Mm, Mm, Hh, Gg^Efm, Mm, Mm, Mm, Hh, Hh, Gg, Gg, Gs, Gs, Gd, Rd, Hhd, Hhd, Gd, Rd, Hhd, Rd, Rd, Rd, Rd, Dd, Hd, Hhd, Rd, Dd, Dd, Dd, Rd^Esd, Hd, Rd, Hd, Dd, Hd, Dd, Dd, Hd, Hd, Md, Hhd, Hhd, Md, Md, Hhd, Mm, Md, Md, Md, Hhd, Gd, Rd, Rd, Hhd, Hhd, Hhd, Md, Hhd, Hhd, Hhd, Hhd, Hhd, Hhd, Gs^Es, Md, Md, Hhd, Md, Gs, Mm, Md, Md, Md, Md, Hh, Md, Uu, Uu, Uu
Uu, Uu, Uu, Uu, Gg, Gll^Fp, Gll^Fp, Gs^Fms, Gll, Gs, Gll^Fp, Gg, Gs, Gs, Gg, Gll^Fp, Gs^Fms, Hh, Hh, Hh, Hh, Ms, Ms, Mm, Mm, Mm, Mm, Mm, Hh, Hh, Hh, Hh, Gs, Gs, Gs, Gs, Gs, Gd, Gd, Hhd, Hhd, Rd, Gd, Gd, Hhd, Hhd, Rd, Hhd, Hhd, Rd, Hd, Dd, Rd, Rd, Dd, Hd, Dd^Edpp, Dd, Rd, Dd, Rd, Dd^Edp, Hhd, Hhd, Hhd, Hd, Md, Md, Md, Mm, Hhd, Md, Hhd, Gd, Gd, Rd, Gd, Hhd, Hhd, Hhd, Md, Hhd, Hhd, Hhd, Hhd, Hhd, Hhd, Gs, Md, Md, Hhd, Md, Md, Hhd^Fdw, Md, Md, Gs, Md, Md, Md, Mm, Uu, Uu, Uu
Uu, Uu, Uu, Uu, Gs, Gs^Fms, Gs, Gg, Gg, Gs^Vl, Gll^Fp, Gs, Gs^Fms, Gg, Gg, Gll^Fp, Gg, Hh^Fp, Gg, Hh, Hh, Mm, Mm, Ms, Mm, Hh, Mm, Hh, Mm, Hh, Gg, Gg, Gg, Gs, Gg, Gs, Gs, Gd, Gs, Rd, Hhd, Gd, Hhd, Hhd, Gd, Gd, Hhd, Gd, Rd, Rd, Dd, Rd, Hhd, Hhd, Hd, Rd, Hhd, Rd, Hd, Hd, Dd, Hd, Hd, Hd, Hd, Md, Hhd, Mm, Md, Mm, Hhd, Mm, Gd, Hhd, Rd, Rd, Hhd, Gd, Mm, Hhd, Hhd, Hhd, Gd, Gd^Dr, Hhd, Hhd, Gd, Hh, Md, Md, Md, Md, Md, Md, Md, Md, Mm, Mm, Mm, Md, Md, Uu, Uu, Uu
Uu, Uu, Uu, Uu, Gll^Fp, Gs, Gs, Gs^Fms, Gll^Fp, Gll, Gs^Fms, Gg, Gs, Gll^Fp, Gs^Fms, Gg, Hh^Fp, Gs, Gg, Hh^Fp, Gg^Efm, Hh^Fp, Hh, Mm, Mm, Mm, Mm, Mm, Mm, Gg, Hh, Hh, Hh, Gs, Gs, Gs, Gs, Gs, Gd, Gd, Hhd, Hhd, Hhd, Gd, Rd, Gd, Rd, Rd, Dd, Rd, Hhd, Rd, Rd, Rd^Esd, Dd, Hhd, Rd, Dd, Rd^Esd, Hd, Hhd, Hhd, Hhd, Hhd, Hhd, Hhd, Md, Md, Gd, Hhd, Hhd, Hhd, Gd, Rd, Hhd, Hhd, Mm, Gd, Hhd, Hhd, Md, Hhd, Gd, Mm, Mm, Md, Md, Md, Md, Md, Md, Md, Md, Md, Md, Hh, Md, Md, Md, Ms, Md, Uu, Uu, Uu
Uu, Uu, Uu, Uu, Gg, Gs, Gg, Gll^Fp, Gs, Gs, Gs, Gs, Gs, Gs^Fms, Gg, Gs, Gg, Gg, Gs^Fms, Gg, Gg, Hh^Fp, Hh^Fds, Hh, Hh, Mm, Mm, Mm, Hh, Hh, Gg, Hh, Hh, Gs, Gs, Gs, Gs, Gd, Gd, Gd, Gd, Gd, Rd, Rd, Rd, Rd, Hhd, Gd, Gd, Rd, Dd, Rd, Rd^Esd, Dd, Rd, Rd, Dd, Rd^Esd, Rd, Hhd, Dd, Rd, Hhd, Hhd, Md, Md, Md, Md, Hhd, Hhd, Gd, Hhd, Rd, Rd, Gd, Gd, Hhd, Mm, Mm, Mm, Md, Md, Md, Gd, Md, Mm, Mm, Md, Md, Md, Mm, Md, Mm, Md, Mm, Mm, Md, Md, Ms, Ms, Ha, Uu, Uu, Uu
Uu, Uu, Uu, Uu, Gg, Gs, Gs, Gs^Fms, Gll^Fp, Gg, Gs^Fms, Gs, Gs, Gs^Fds, Gs, Gs, Gs, Gg, Gs, Gg, Gs, Hh^Fp, Gg, Gg, Hh, Mm, Mm, Mm, Mm, Hh, Hh, Gg, Gs, Gg, Gs, Gs, Gg, Gs, Gd, Hhd, Hhd, Hhd, Hhd, Rd, Gd, Rd, Gd, Hhd, Gd, Rd, Rd, Hd, Rd, Rd, Dd, Rd, Hhd, Hhd, Hhd, Dd, Dd, Rd, Hhd, Hhd, Md, Md, Hhd, Hhd, Gd, Gd, Rd, Rd, Md, Hh, Md, Hhd, Hhd, Gd, Hh, Gd^Vhr, Md, Md, Md, Md, Md, Md, Mm, Md, Mm, Mm, Mm, Mm, Md, Md, Md, Md, Ms, Ms, Md, Hh, Ms, Uu, Uu, Uu
Uu, Uu, Uu, Uu, Gg, Gll^Fp, Gll, Gg, Gll^Fp, Gs, Gg, Gll^Fp, Gs^Fms, Gg, Gll^Fp, Gg, Gs^Fms, Gs^Fms, Gs, Gs, Gs^Fms, Gg, Gg, Gg, Hh^Fp, Hh, Hh^Vhh, Mm, Hh, Hh, Hh, Gs, Gg, Gg, Hh, Gg, Hh, Hh, Hh, Gd, Gd, Gd, Gd, Hhd, Hhd, Gd, Rd, Hhd, Rd, Rd, Dd, Rd, Rd, Hhd, Rd, Rd, Md, Md, Hhd, Hhd, Hhd, Hhd, Hh, Md, Mm, Mm, Hhd, Hhd, Gd^Vhr, Rd, Hhd, Hhd, Md, Md, Hhd, Hhd, Md, Hhd, Hh, Ce, Ke, Mm, Mm, Md, Ms, Ms, Ms, Mm, Mm, Md, Md, Ms, Ms, Md, Ms, Ms, Ms, Ms, Ms, Ms, Hh, Uu, Uu, Uu
Uu, Uu, Uu, Uu, Gs^Fms, Gll, Gs, Gs, Gll^Fp, Gll, Gs, Gs, Gs, Gll^Fp, Gs^Vh, Gs^Fms, Gg, Gs^Fms, Gg, Gs, Gs^Fms, Gg, Gg, Gll^Fp, Gg^Efm, Hh, Hh, Mm, Mm, Hh, Hh, Hh, Hh, Hh, Hh^Vhh, Hh, Hh, Hh, Hh, Hh, Gd, Hh, Gd, Gd, Hhd, Gd, Hhd, Gd, Gd, Rd, Rd, Rd, Rd^Dr, Gd, Hhd, Hhd, Md, Md, Hhd, Hh, Md, Md, Mm, Mm, Hhd, Hhd, Hhd, Gs, Rd, Rd, Hhd, Md, Md, Md, Hhd, Gd^Es, Mm, Md, Md, Ce, Md, Md, Md, Md, Ms, Wo, Wo, Ms, Ms, Mm, Md, Ms, Ms, Ms, Ms, Gg, Ms, Ms, Ha, Ms, Md, Uu, Uu, Uu
Uu, Uu, Uu, Uu, Gll^Fp, Gg, Gs^Fms, Gs, Gs, Gs^Fms, Gll^Fp, Gs^Fms, Gs^Fms, Gs, Gs, Gs^Fms, Gg, Gs^Fms, Gll^Fp, Gg, Gll^Fp, Gs^Fms, Gg, Gg, Gs, Hh^Fds, Gs, Hh, Mm, Mm, Mm, Hh, Mm, Mm, Mm, Mm, Mm, Hh, Hh, Gs, Gs, Hh, Hhd, Gd, Hhd, Gd, Gd, Rd, Hhd, Rd, Rd, Gd, Rd, Rd, Hhd, Md, Md, Md, Md, Md, Mm, Md, Mm, Hhd, Hhd, Gs, Rd, Rd, Gs, Hhd, Hhd, Md, Md, Hhd, Gd, Gd, Mm, Mm, Mm, Md, Mm, Md, Ms, Ms, Ms, Ms, Ms, Ms, Ha, Ms, Md, Ms, Ms, Ms, Ms, Ms, Ww, Ww, Mm, Md, Md, Uu, Uu, Uu
Uu, Uu, Uu, Uu, Gg, Gs^Fms, Gll^Fp, Gs, Gs, Gg, Gg, Gs^Fds, Gs, Gs, Gg, Gs, Gs, Gs^Fds, Gs, Gs, Gg, Gs^Fds, Gs^Fms, Gg, Gll^Fp, Gg, Hh, Hh, Hh, Mm, Mm, Mm, Mm, Mm, Hh, Mm, Hh, Mm, Gs, Gs, Gs, Hh, Hh, Hh, Hhd, Hhd, Hhd, Rd, Hhd, Gd, Gd, Hhd, Gd^Es, Gd, Gd, Hhd^Vhhr, Md, Md, Md, Mm, Mm, Mm, Hh, Gs, Rd, Re, Gs, Hhd, Hhd, Gd, Hhd, Hhd, Hhd, Md, Gs, Md, Mm, Mm, Mm, Mm, Mm, Ms, Ms, Ww, Ww, Ha, Mm, Ww, Ww, Md, Mm, Ms, Mm, Gg, Mm, Mm, Ww, Mm, Hh, Mm, Md, Uu, Uu, Uu
Uu, Uu, Uu, Uu, Gg, Gll, Gg, Gg, Gg, Gs, Gs, Gs^Fms, Gs^Fms, Gs^Fms, Gll^Fp, Gg, Gg, Gs, Gs^Fms, Gg, Gs, Gg, Gg, Gg, Gg, Gs^Fms, Gg, Gg, Hh, Hh^Fp, Hh, Mm, Hh, Gg, Mm, Hh, Hh, Hh, Gg, Hh, Gs, Hh, Gs, Gd, Hh, Hhd, Hhd, Gd, Gd, Rd, Gd, Hhd, Hh, Hhd, Hh, Hhd, Md, Md, Md, Mm, Hh, Hh, Gg, Hh, Re, Hhd, Hhd, Gs, Hhd, Hhd, Gd, Hhd, Hhd, Mm, Mm, Md, Mm, Mm, Mm, Mm, Mm, Ms, Ha, Ww, Mm, Mm, Mm, Mm, Ww, Mm, Mm, Mm, Hh, Hh, Gg, Wo, Ww, Gg, Ss, Hh, Hh, Uu, Uu, Uu
Uu, Uu, Uu, Uu, Gs^Fms, Gs^Fms, Gg, Gs^Fms, Gs^Fms, Gs^Fms, Gg, Gll^Fp, Gs^Fms, Gg^Efm, Gs^Fms, Gs^Fms, Gs^Fms, Gs, Gs, Gg, Gll^Fp, Gs, Gg, Gs^Fms, Gs^Fms, Gs^Fms, Gg, Gg, Gg, Gg, Gg, Hh, Gg, Hh, Gs, Gs, Gs, Gs, Gs, Hh, Hh, Hh, Gs, Hh, Gs, Gd, Hhd, Hhd, Hh, Gd, Hh, Hhd, Md, Md, Md, Md, Md, Md, Md, Mm, Hh, Hh, Gg, Re, Gs, Hhd, Hhd, Hhd, Md, Md, Md, Gd, Gs, Hhd, Mm, Hh, Mm, Mm, Hh, Mm, Md, Mm, Mm, Ww, Ss, Mm, Hh, Mm, Wo, Hh, Hh, Ss, Hh, Hh, Ss, Ww, Ss, Ww, Ww, Md, Ds, Uu, Uu, Uu
Uu, Uu, Uu, Uu, Gg, Gg, Gs, Gs^Fms, Gs, Gs, Gs, Gs, Gs^Fms, Gll^Fp, Gg, Gg, Gs, Gs, Gll^Fp, Gg, Gs^Fms, Gs^Fms, Gs^Fms, Gs, Gs, Gs^Fms, Gg, Gs^Fms, Gg, Gs^Fms, Gg, Gg, Gs, Gs, Gg, Hh, Md, Hh^Vhh, Mm, Mm, Mm, Hh, Hh, Hh, Md, Hh, Hh, Hhd, Hh, Md, Md, Md, Md, Md, Md, Md, Md, Md, Mm, Hh, Hh, Hh, Gg, Re, Hhd, Hhd, Gs, Md, Gg, Hh, Md, Md, Mm, Mm, Hh, Mm, Hh, Hh, Hh, Hh, Hh^Vhh, Hh, Gg, Ww, Ss, Hh, Hh, Gg, Gg, Ww, Ww, Ss, Hh, Ss, Ss, Ww, Ss, Ss, Gg, Ww, Wo, Uu, Uu, Uu
Uu, Uu, Uu, Uu, Gll, Gs, Gs, Gg, Gs^Fms, Gs, Gs, Gs^Fms, Gg, Gs^Fms, Gs^Fms, Gs^Fms, Gs^Fms, Gs^Fms, Gg, Gs^Fms, Gg, Gll^Fp, Gs^Fms, Gg, Gg, Gs, Gs, Gg, Gs^Fms, Gs, Gs, Gs, Gg, Gg, Hh, Hh, Hh, Md, Md, Mm, Md, Hh, Hh, Gg, Md, Hh, Md, Hh, Md, Md, Ms, Md, Md, Md, Hh, Md, Hh, Mm, Hh, Mm, Hh, Hh, Gg, Rb, Gs, Hhd, Hhd, Md, Gs, Gg, Mm, Mm, Hh, Hh, Hh, Hh, Hh, Hh, Gg, Gg, Ww, Gg, Ww, Ww, Ss, Ss, Hh, Ss, Ss, Ss, Ww, Gg, Ss, Ss, Ww, Ww, Ss, Gg, Ss, Ss, Ss, Uu, Uu, Uu
Uu, Uu, Uu, Uu, Gll^Fp, Gs, Gs, Gs, Gg, Gg, Gs, Gg, Gs^Fms, Gs, Gs, Gg, Gll^Fp, Gll, Gs, Gs^Fms, Gs^Fms, Gs^Fms, Gs^Fds, Gs^Fms, Gg, Gg, Gg, Gs^Fms, Gs^Fms, Gs^Fms, Gg, Gs, Gg, Gs^Fms, Gg, Hh, Hh, Hh, Hh, Md, Md, Hh, Md, Md, Md, Md, Md, Md, Md, Ms, Ha, Ms, Mm, Md, Hh, Mm, Hh, Mm, Mm, Mm, Mm, Gs, Gg, Rb, Hhd, Hhd, Gs, Md, Hh, Mm, Mm, Hh, Mm, Hh, Hh, Gg, Hh, Hh, Gg, Ss, Ww, Ww, Ss, Ww, Ss, Hh, Ww^Ewf, Ss, Wo, Ww, Ss, Ss, Ss, Ss, Ww, Ss, Ss, Gg, Ss, Ss, Ss, Uu, Uu, Uu
Uu, Uu, Uu, Uu, Gll, Gll, Gg, Gs, Gs^Fms, Gs^Fms, Gs^Fms, Gs, Gg, Gg, Gs^Fms, Gs, Gs, Gs, Gg, Gg, Gs, Gll^Fp, Gs^Fms, Gs^Fms, Gs^Fms, Gs, Gs, Gs^Fms, Gs, Gg, Gs^Fms, Gg, Gs^Fms, Gg, Gs^Fms, Gg, Gs, Gs, Gg, Hh, Hh, Md, Mm, Mm, Mm, Mm, Mm, Md, Mm, Mm, Wo, Ms, Mm, Mm, Hh^Vhh, Hh, Hh, Gg, Hh, Mm, Hh, Hh, Gs, Re, Md, Md, Mm, Mm, Md, Hh, Hh, Mm, Mm, Gs, Gg, Hh, Gg, Gg, Ss, Ss, Ww, Ss, Ss, Ww, Ss, Hh, Ss, Ss, Ww, Gg, Ss, Ss, Wwf, Ww, Rb, Ss, Ss, Ss, Ss, Gg^Efm, Ss, Uu, Uu, Uu
Uu, Uu, Uu, Uu, Gll^Fp, Gs, Gs^Fms, Gs^Fms, Gs^Vh, Gs^Fms, Gg, Gs, Gll^Fp, Gs^Fds, Gs^Fds, Gg, Gs^Fms, Gs^Fms, Gg, Gs^Fms, Gll^Fp, Gs^Fms, Gs, Gs^Vc, Gs^Fms, Gg, Gs^Fds, Gg, Gg, Gg, Gg, Gs^Fms, Gs^Fms, Gs^Fms, Gg, Gg, Gs^Fds, Gll^Fp, Gg, Hh, Gg, Gg, Hh, Hh, Hh, Mm, Hh, Mm, Hh, Hh, Ww, Hh, Hh, Hh, Gg, Hh, Gs, Gg, Hh, Mm, Mm, Gs, Hh, Re, Chr, Md, Hh, Mm, Hh, Gs, Hh, Hh, Mm, Hh, Hh, Gg, Ss, Gg, Rb, Ss, Ww, Ss, Gg, Ss, Ss, Gg, Rb, Wo, Ss, Sm, Sm, Wwf, Wwf, Rb, Gg^Efm, Rb, Sm, Ss, Ss, Ss, Ss, Uu, Uu, Uu
Uu, Uu, Uu, Uu, Gll^Fp, Gg, Gs, Gs^Fms, Gs, Gs^Fms, Gs, Gs^Fms, Gg, Gg^Efm, Gg, Gg, Gs^Fms, Gg, Gg, Gll^Fp, Gs^Fms, Gg^Efm, Gll^Fp, Gs^Fds, Gs^Fms, Gs^Fms, Gg, Gs^Fms, Gs^Fds, Gg, Gs^Fds, Gg, Gg, Gg, Gg, Gg, Gg, Gg, Gg, Gg, Gg, Gg, Gg, Gg^Efm, Hh, Hh, Hh, Hh, Wo, Ww, Gg^Efm, Hh, Gg, Gs, Gg, Hh, Hh, Gs, Gs, Hh, Hh, Chr, Rr, Re, Gd^Vhr, Hh, Hh, Hh, Md, Hh, Hh, Gg, Gs, Gg, Gg, Gg, Rb, Rb, Ss, Rb, Wwf, Ss, Sm, Sm, Rb, Rb, Ss, Wo^Bw\r, Rb, Rb, Ss, Ss, Ww, Ss, Ss, Ss, Ss, Rb, Rb, Rb, Ss, Uu, Uu, Uu
Uu, Uu, Uu, Uu, Gs^Fms, Gg, Gs, Gs, Gg, Gs, Gs, Gs^Fms, Gs^Fms, Gs^Fds, Gs, Gs, Gg, Gs^Fms, Gs^Fms, Gs^Fds, Gs^Fms, Gs^Fms, Gg, Gs, Gg, Gg, Gg, Gg, Gs^Fds, Gg, Gg, Gg, Gs^Fds, Gs^Fms, Gg, Gg, Gs^Fds, Gg, Gg, Gg, Ww, Gg, Wwf, Ww, Ww, Ww, Wo, Ww, Gg, Hh, Gg, Hh, Gg, Gs, Gg, Gg, Gs, Hh, Gs, Gs, Re, Rp, Chr, Re, Rp, Hh, Gg, Hh, Hh, Gg, Hh, Gg, Gs, Gg, Re, Rb, Ss, Ss, Ss, Wo, Ss, Rb, Ss, Ww, Ss, Ss, Ww, Wo, Ss, Ss, Ss, Ss, Wo, Ss, Ss^Efm, Ss, Ss, Ss, Gg, Ss, Rb, Uu, Uu, Uu
Uu, Uu, Uu, Uu, Gll^Fp, Gll, Gs, Gs^Fms, Gll^Fp, Gs, Gs, Gg, Gs, Gg, Gs, Gg, Gs^Fms, Gg, Gs^Fds, Gs, Gs, Gg, Gs^Fms, Gs^Fms, Gs^Fds, Gg, Gs^Fds, Gs^Fds, Gg, Gg, Gg, Gg, Gg, Gs^Fds, Gg, Gg, Ww, Gg, Ww, Ww, Gg, Ww, Gs^Vc, Gg, Gg, Hh, Hh, Gg, Gg, Gg, Gg, Gg, Gg, Gg, Gs, Gs, Gg, Gg, Rp, Rp, Hh, Hh, Hh, Gg, Gg, Re, Rp, Hh, Gg, Gs, Gg, Hh, Re, Rb, Gg, Gg, Ss, Ss, Ww, Ww, Ss, Ss, Gg^Efm, Ww, Ww, Ss, Ss, Ww, Ww, Ww, Ss, Ww, Ww, Ss, Ss, Gg^Efm, Ss, Ss, Ss, Ss, Rb, Uu, Uu, Uu
Uu, Uu, Uu, Uu, Gs^Fms, Gll^Fp, Gs^Fms, Gs^Fms, Gll, Gg, Gg, Gg, Gg, Gs^Fms, Gg, Gg, Gs^Fds, Gg, Gg, Gg, Gs^Fms, Gg, Gg, Gs^Fms, Gg, Gs^Fds, Wo, Wo, Ww, Gs^Fms, Ww, Ww, Ww, Gg, Ww, Ww, Gs^Fds, Ww, Gg, Gg, Gg, Gg, Gg, Gg, Gg, Gg, Gg, Gg, Gg, Gg, Gg, Gg, Gg, Gs, Gs, Gs, Gg, Rr, Gs, Hh, Hh, Hh, Hh, Gs, Hh, Gs, Hh, Re, Re, Hh, Re, Re, Hh, Gg, Hh, Ss, Ss, Gg, Ww, Ss, Ss, Ss, Ss, Ss, Ww, Ss, Ss, Ww, Ww, Ww, Ww, Ss, Ww, Ss, Ss, Ss, Sm, Ss, Gg, Rb, Ss, Uu, Uu, Uu
Uu, Uu, Uu, Uu, Gg, Gg, Gs, Gs, Gs^Fms, Gs^Fms, Gll^Fp, Gs^Fms, Gg, Gs^Fds, Gg, Gs^Fds, Gg, Gg, Gs^Fds, Gg, Gs^Fms, Gg, Gs^Fms, Gg, Wo, Wo, Gg, Gg, Gg, Ww, Gs^Fds, Gg, Gg, Ww, Gg, Gg, Rb, Gg, Rb, Gg, Gg, Gg, Gs, Gg, Gg, Gg, Gg, Gg, Gg, Gs, Gg, Gg, Gs, Gg, Gs, Gg, Re, Rp, Gg, Hh, Hh, Hh, Gg, Gs, Hh, Md, Md, Hh, Hh, Re, Hh, Gs, Hh, Hh, Hh, Ss, Gg^Efm, Ww, Ww, Ww, Ww, Ds, Ds, Gg, Ww, Ww, Ww, Ww, Wo, Ww, Wo, Wo, Wo, Ww, Wo, Ww, Ww, Ss^Vhs, Rb^Bw/r, Rb, Ss, Uu, Uu, Uu
Uu, Uu, Uu, Uu, Gg, Gs^Fds, Gll^Fp, Gs, Gs^Fms, Gg, Gs^Fms, Gll^Fp, Gs^Fms, Gs, Gs^Fms, Gs^Fms, Gg, Gs^Fms, Gs^Fms, Gs^Fds, Gg, Gs^Fms, Gs^Fms, Gg, Wo, Gg^Efm, Gg, Gs^Fms, Gg, Gs^Vc, Gg, Gg, Gg, Gg, Rb, Rb, Gg, Rb, Gg, Rb, Rb, Gg, Gg, Gg, Gg, Gs, Gg, Gg, Gg, Gs, Gs, Gs, Gg, Gg, Gg, Gg, Rp, Gs, Hh, Gg, Gg, Hh, Hh, Hh, Md, Md, Md, Md, Gg, Rp, Gg, Hh, Md, Mm, Hh, Hh, Ww, Ww, Wo, Wo, Ww, Ww, Ww, Ww, Ww, Ww, Ww, Wo, Wo, Wo, Wo, Wo, Wo, Wo, Wo, Wo, Ww, Ww, Ww, Ss, Ww, Uu, Uu, Uu
Uu, Uu, Uu, Uu, Gg, Gs, Gs, Gg, Gg, Gs, Gs^Fms, Gll^Fp, Gg, Gs, Gs, Gs^Fms, Gs^Fds, Gs^Fms, Gs, Gg, Gg, Gs^Fms, Gg, Gg, Wo, Gs^Fms, Gg, Gg, Gg, Gs^Fds, Gs^Fds, Gg, Rb, Rb, Gs, Gg, Gg, Gg, Gg, Gg, Gg, Rb, Rb, Gs, Gg, Gg, Gs, Gg, Gg, Gs, Gs, Gs, Gs, Gs, Gs, Gg, Rp, Hh, Hh, Gs, Hh, Hh, Gg, Hh, Uu, Md, Uu, Md, Uu, Rr, Uu, Hh, Uu, Mm, Uu, Ss, Uu, Ww, Uu, Wo, Uu, Ww, Uu, Ww, Uu, Ss^Vhs, Uu, Ww, Uu, Wo, Uu, Wo, Uu, Ww, Uu, Wo, Uu, Ww, Uu, Ww, Uu, Uu, Uu, Uu
Uu, Uu, Uu, Uu, Gs^Fms, Gs, Gs, Gs^Fms, Gs, Gs, Gs^Fms, Gs^Fms, Gg, Gs^Fms, Gg, Gs^Fms, Gs, Gs^Fms, Gs, Gg, Gs^Fms, Gs^Fms, Gg, Gs^Fds, Ss, Wo, Wo, Gg, Gg, Gg, Rb, Rb, Gg, Gg, Gg, Gg, Gg, Gg, Gg, Gg, Gg, Gg, Gg, Rb, Gg, Gg, Gs, Gg, Gs, Gg, Gg, Gs, Gs, Gg, Gs, Gs^Vh, Rp, Gg, Gs, Hh, Gg, Gs, Gg, Uu, Uu, Uu, Uu, Uu, Uu, Uu, Uu, Uu, Uu, Uu, Uu, Uu, Uu, Uu, Uu, Uu, Uu, Uu, Uu, Uu, Uu, Uu, Uu, Uu, Uu, Uu, Uu, Uu, Uu, Uu, Uu, Uu, Uu, Uu, Uu, Uu, Uu, Uu, Uu, Uu
Uu, Uu, Uu, Uu, Gg, Gs, Gs^Fds, Gs^Fds, Gs, Gs^Fms, Gg, Gs, Gs^Fds, Gs^Fms, Gg, Gs^Fds, Gs^Fds, Gg, Gg, Gg, Gg, Gg, Gs^Fms, Gs^Fds, Gg, Gg, Gs^Fms, Ww, Gs^Fds, Rb, Gg, Gg, Gg, Gg, Gg, Gg, Gg, Gg, Gg, Gg, Gs, Gs, Gg, Rb, Gg, Gg, Gg, Gs, Gg, Gs, Gs, Gs, Gs, Gg, Gs, Rp, Gs, Gs, Gg, Gs, Gs, Hh, Gs, Uu, Uu, Uu, Uu, Uu, Uu, Uu, Uu, Uu, Uu, Uu, Uu, Uu, Uu, Uu, Uu, Uu, Uu, Uu, Uu, Uu, Uu, Uu, Uu, Uu, Uu, Uu, Uu, Uu, Uu, Uu, Uu, Uu, Uu, Uu, Uu, Uu, Uu, Uu, Uu, Uu
Uu, Uu, Uu, Uu, Gs, Gs^Fds, Gs^Fms, Gg, Gs, Gs, Gs^Fms, Gs, Gg, Gs, Gs, Gs^Fms, Gg, Gs^Fms, Gg, Gs^Fms, Gs, Gg, Gs^Fds, Gs^Fms, Gg, Gg, Gs^Fds, Wo, Gg, Rb, Gg, Gg, Gg, Gg, Gg, Gg, Gg, Gg, Gg, Gg, Gg, Gs, Gg, Rb, Gg, Gs, Gs, Gs, Gs, Gs, Gs, Gs, Gs, Gs, Gg, Rp, Gg, Gg, Gs, Gs, Gg, Gg, Gg, Uu, Uu, Uu, Uu, Uu, Uu, Uu, Uu, Uu, Uu, Uu, Uu, Uu, Uu, Uu, Uu, Uu, Uu, Uu, Uu, Uu, Uu, Uu, Uu, Uu, Uu, Uu, Uu, Uu, Uu, Uu, Uu, Uu, Uu, Uu, Uu, Uu, Uu, Uu, Uu, Uu
Uu, Uu, Uu, Uu, Gs, Gs, Gs, Gg, Gs^Fms, Gg, Gs^Fms, Gll^Fp, Gs^Fms, Gs^Vl, Gs^Fms, Gs^Fms, Gs^Fms, Gg, Gg, Gs^Fms, Gs^Fds, Gg, Gg, Gg, Gg, Gg, Wo, Ww, Gg, Rb, Gg, Gg, Gg, Gg, Gs, Gg, Gs, Gg, Gg, Gs, Gg, Gs, Gg, Rb, Gg, Gg, Gs, Gs, Gg, Gs, Gg, Gs, Gs, Gg, Gg, Re, Gg, Gs, Gs, Gs, Gs, Gs, Gg, Uu, Uu, Uu, Uu, Uu, Uu, Uu, Uu, Uu, Uu, Uu, Uu, Uu, Uu, Uu, Uu, Uu, Uu, Uu, Uu, Uu, Uu, Uu, Uu, Uu, Uu, Uu, Uu, Uu, Uu, Uu, Uu, Uu, Uu, Uu, Uu, Uu, Uu, Uu, Uu, Uu
Uu, Uu, Uu, Uu, Gs, Gs^Fms, Gs^Fds, Gg, Gs, Gg, Gs^Fms, Gs^Fms, Gs, Gs^Fms, Gg, Gs, Gs, Gs, Gg, Gs^Fds, Gg, Gg, Gg, Gs^Fds, Gg, Gg, Wo, Gg, Gg, Rb, Gg, Gg, Gg, Gg, Gg, Gs, Gg, Gg, Rb, Gg, Rb, Gg, Rb, Rb, Gg, Gg, Gs, Gg, Gg, Gs, Gs, Gs, Gs, Gs, Rp, Rp, Gg, Gg, Gg, Gg, Gg, Gs, Rb^Eff, Uu, Uu, Uu, Uu, Uu, Uu, Uu, Uu, Uu, Uu, Uu, Uu, Uu, Uu, Uu, Uu, Uu, Uu, Uu, Uu, Uu, Uu, Uu, Uu, Uu, Uu, Uu, Uu, Uu, Uu, Uu, Uu, Uu, Uu, Uu, Uu, Uu, Uu, Uu, Uu, Uu
Uu, Uu, Uu, Uu, Gg, Gs^Fds, Gs^Fds, Gs, Gg, Gg, Gg, Gs, Gs, Gs^Fms, Gg, Gs^Fms, Gg, Gg, Gg, Gs^Fms, Gg, Gg, Gg, Gs^Fms, Wo, Wo, Gg^Efm, Gg, Gg, Rb, Rb, Gg, Rb, Gg, Rb, Gg, Rb, Rb, Gg, Rb, Gg, Rb, Gg, Gg, Gg, Gs, Gg, Gs, Gs, Gs, Gs, Gs, Gg, Gs, Re, Gs, Gg, Gg, Ww, Gg, Rb^Eff, Rb^Eff, Rb^Gvs, Uu, Uu, Uu, Uu, Uu, Uu, Uu, Uu, Uu, Uu, Uu, Uu, Uu, Uu, Uu, Uu, Uu, Uu, Uu, Uu, Uu, Uu, Uu, Uu, Uu, Uu, Uu, Uu, Uu, Uu, Uu, Uu, Uu, Uu, Uu, Uu, Uu, Uu, Uu, Uu, Uu
Uu, Uu, Uu, Uu, Gll, Gs^Fms, Gs, Gs, Gll^Fp, Gg, Gs^Fds, Gs^Fms, Gg, Gs, Gs^Fds, Gg, Gg, Gs^Fms, Gs^Fms, Gs^Fds, Gs^Fds, Gg, Gs^Fds, Gs^Fds, Wo, Gs^Fds, Gs^Fms, Gs^Fds, Gg, Gg, Gs^Fds, Rb, Gg, Rb, Gs, Rb, Gs, Gs, Gg, Gs, Gs, Gs, Gs, Gg, Gs, Gs^Vh, Re, Gs, Gg, Gg, Gs, Gg, Re, Re, Gs, Gs^Vc, Gg, Ww, Rb^Eff, Rb^Eff, Rb^Gvs, Rb^Gvs, Rb^Gvs, Uu, Uu, Uu, Uu, Uu, Uu, Uu, Uu, Uu, Uu, Uu, Uu, Uu, Uu, Uu, Uu, Uu, Uu, Uu, Uu, Uu, Uu, Uu, Uu, Uu, Uu, Uu, Uu, Uu, Uu, Uu, Uu, Uu, Uu, Uu, Uu, Uu, Uu, Uu, Uu, Uu
Uu, Uu, Uu, Uu, Gg, Gll, Gg, Gll^Fp, Gs^Fms, Gs^Fms, Gg, Gg, Gs^Fms, Gs^Fms, Gs^Fms, Gg, Gs^Fms, Gs^Fds, Gg, Gg, Gs^Fms, Gs^Fds, Gg, Gs^Fds, Wo, Ss, Gg, Gg, Gg, Gg, Gs^Fds, Gg, Gg, Gs, Gg, Gg, Gg, Gg, Gg, Gg, Gg, Gg, Gg, Gg, Gg, Gg, Gg, Re, Re, Gs, Gg, Gg, Re, Gg, Gg, Gg, Rb^Eff, Rb^Eff, Rb^Gvs, Rb^Gvs, Rb^Gvs, Rb^Gvs, Rb^Gvs, Uu, Uu, Uu, Uu, Uu, Uu, Uu, Uu, Uu, Uu, Uu, Uu, Uu, Uu, Uu, Uu, Uu, Uu, Uu, Uu, Uu, Uu, Uu, Uu, Uu, Uu, Uu, Uu, Uu, Uu, Uu, Uu, Uu, Uu, Uu, Uu, Uu, Uu, Uu, Uu, Uu
Uu, Uu, Uu, Uu, Uu, Uu, Uu, Uu, Uu, Uu, Uu, Uu, Uu, Uu, Uu, Uu, Uu, Uu, Uu, Uu, Uu, Uu, Uu, Uu, Uu, Uu, Uu, Uu, Uu, Uu, Uu, Uu, Uu, Uu, Uu, Uu, Uu, Uu, Uu, Uu, Uu, Uu, Uu, Uu, Uu, Uu, Uu, Uu, Uu, Uu, Uu, Uu, Uu, Uu, Uu, Uu, Uu, Uu, Uu, Uu, Uu, Uu, Uu, Uu, Uu, Uu, Uu, Uu, Uu, Uu, Uu, Uu, Uu, Uu, Uu, Uu, Uu, Uu, Uu, Uu, Uu, Uu, Uu, Uu, Uu, Uu, Uu, Uu, Uu, Uu, Uu, Uu, Uu, Uu, Uu, Uu, Uu, Uu, Uu, Uu, Uu, Uu, Uu, Uu
Uu, Uu, Uu, Uu, Uu, Uu, Uu, Uu, Uu, Uu, Uu, Uu, Uu, Uu, Uu, Uu, Uu, Uu, Uu, Uu, Uu, Uu, Uu, Uu, Uu, Uu, Uu, Uu, Uu, Uu, Uu, Uu, Uu, Uu, Uu, Uu, Uu, Uu, Uu, Uu, Uu, Uu, Uu, Uu, Uu, Uu, Uu, Uu, Uu, Uu, Uu, Uu, Uu, Uu, Uu, Uu, Uu, Uu, Uu, Uu, Uu, Uu, Uu, Uu, Uu, Uu, Uu, Uu, Uu, Uu, Uu, Uu, Uu, Uu, Uu, Uu, Uu, Uu, Uu, Uu, Uu, Uu, Uu, Uu, Uu, Uu, Uu, Uu, Uu, Uu, Uu, Uu, Uu, Uu, Uu, Uu, Uu, Uu, Uu, Uu, Uu, Uu, Uu, Uu
Uu, Uu, Uu, Uu, Uu, Uu, Uu, Uu, Uu, Uu, Gg, Uu, Gs^Fms, Uu, Gg, Uu, Gs^Fms, Uu, Gs^Fms, Uu, Gs^Fms, Uu, Gs^Fds, Uu, Wo, Uu, Gg, Uu, Gg, Uu, Gg, Uu, Gg, Uu, Rb, Uu, Uu, Uu, Uu, Uu, Uu, Uu, Uu, Uu, Uu, Uu, Uu, Uu, Uu, Uu, Uu, Uu, Uu, Uu, Uu, Uu, Uu, Uu, Uu, Uu, Uu, Uu, Uu, Uu, Uu, Uu, Uu, Uu, Uu, Uu, Uu, Uu, Uu, Uu, Uu, Uu, Uu, Uu, Uu, Uu, Uu, Uu, Uu, Uu, Uu, Uu, Uu, Uu, Uu, Uu, Uu, Uu, Uu, Uu, Uu, Uu, Uu, Uu, Uu, Uu, Uu, Uu, Uu, Uu
Uu, Uu, Uu, Uu, Uu, Uu, Uu, Uu, Uu, Gg, Gs, Gs^Fms, Gs^Fds, Gs^Es, Gs^Fms, Gs^Fms, Gg, Gs^Fms, Gs^Fms, Gs^Fds, Gg, Gg, Gg, Gg, Ww, Wo, Wwg, Gs^Fds, Gg^Efm, Gs^Fds, Gg, Gs^Fds, Rb, Rb, Gs^Fds, Uu, Uu, Uu, Uu, Uu, Uu, Uu, Uu, Uu, Uu, Uu, Uu, Uu, Uu, Uu, Uu, Uu, Uu, Uu, Uu, Uu, Uu, Uu, Uu, Uu, Uu, Uu, Uu, Uu, Uu, Uu, Uu, Uu, Uu, Uu, Uu, Uu, Uu, Uu, Uu, Uu, Uu, Uu, Uu, Uu, Uu, Uu, Uu, Uu, Uu, Uu, Uu, Uu, Uu, Uu, Uu, Uu, Uu, Uu, Uu, Uu, Uu, Uu, Uu, Uu, Uu, Uu, Uu, Uu
Uu, Uu, Uu, Uu, Uu, Uu, Uu, Uu, Uu, Gg^Es, Gs^Fms, Gs^Fds, Gs^Fds, Gg, Gg, Gs, Ce, Ce, Ce, Ce, Ce, Ce, Ce, Ce, Ce, Ww, Ww, Gs^Fds, Gg, Gg, Rb, Rb, Gg, Gg, Gll^Fp, Uu, Uu, Uu, Uu, Uu, Uu, Uu, Uu, Uu, Uu, Uu, Uu, Uu, Uu, Uu, Uu, Uu, Uu, Uu, Uu, Uu, Uu, Uu, Uu, Uu, Uu, Uu, Uu, Uu, Uu, Uu, Uu, Uu, Uu, Uu, Uu, Uu, Uu, Uu, Uu, Uu, Uu, Uu, Uu, Uu, Uu, Uu, Uu, Uu, Uu, Uu, Uu, Uu, Uu, Uu, Uu, Uu, Uu, Uu, Uu, Uu, Uu, Uu, Uu, Uu, Uu, Uu, Uu, Uu
Uu, Uu, Uu, Uu, Uu, Uu, Uu, Uu, Uu, Gg, Gs^Fds, Gg, Gg, Gg^Efm, Ce, Ce, Rrc, Rrc, Rr, Rrc, Rrc, Rr, Rr, Rp^Vhcr, Rp^Vhcr, Ce, Ce, Ww, Wwf^Bw/, Rb, Gg, Gg^Efm, Gg^Em, Gs^Fds, Gg, Uu, Uu, Uu, Uu, Uu, Uu, Uu, Uu, Uu, Uu, Uu, Uu, Uu, Uu, Uu, Uu, Uu, Uu, Uu, Uu, Uu, Uu, Uu, Uu, Uu, Uu, Uu, Uu, Uu, Uu, Uu, Uu, Uu, Uu, Uu, Uu, Uu, Uu, Uu, Uu, Uu, Uu, Uu, Uu, Uu, Uu, Uu, Uu, Uu, Uu, Uu, Uu, Uu, Uu, Uu, Uu, Uu, Uu, Uu, Uu, Uu, Uu, Uu, Uu, Uu, Uu, Uu, Uu, Uu
Uu, Uu, Uu, Uu, Uu, Uu, Uu, Uu, Uu, Gg, Gg^Es, Gs, Gs^Fms, Ce, Rrc, Rrc, Rp^Vhcr, Rp^Vhcr, Rr^Vhc, Rrc, Rp^Vhcr, Rrc, Rp^Vhcr, Rp^Vhcr, Rr, Rr, Rr, Rr, Wwf, Wwf, Ww, Gg, Gg^Em, Gs^Fds, Gs^Fds, Uu, Uu, Uu, Uu, Uu, Uu, Uu, Uu, Uu, Uu, Uu, Uu, Uu, Uu, Uu, Uu, Uu, Uu, Uu, Uu, Uu, Uu, Uu, Uu, Uu, Uu, Uu, Uu, Uu, Uu, Uu, Uu, Uu, Uu, Uu, Uu, Uu, Uu, Uu, Uu, Uu, Uu, Uu, Uu, Uu, Uu, Uu, Uu, Uu, Uu, Uu, Uu, Uu, Uu, Uu, Uu, Uu, Uu, Uu, Uu, Uu, Uu, Uu, Uu, Uu, Uu, Uu, Uu, Uu
Uu, Uu, Uu, Uu, Uu, Uu, Uu, Uu, Uu, Gs^Fds, Gs^Fds, Gs^Fds, Gg, Ce, Rr, Rp^Vhcr, Rr^Vhc, Rrc, Rr, Rp^Vhcr, Rr^Vhc, Rrc, Rrc, Rrc, Rr, Rb, Rp, Ce, Ce, Wwg, Wwg, Ww, Ww, Gs^Fms, Gg, Uu, Uu, Uu, Uu, Uu, Uu, Uu, Uu, Uu, Uu, Uu, Uu, Uu, Uu, Uu, Uu, Uu, Uu, Uu, Uu, Uu, Uu, Uu, Uu, Uu, Uu, Uu, Uu, Uu, Uu, Uu, Uu, Uu, Uu, Uu, Uu, Uu, Uu, Uu, Uu, Uu, Uu, Uu, Uu, Uu, Uu, Uu, Uu, Uu, Uu, Uu, Uu, Uu, Uu, Uu, Uu, Uu, Uu, Uu, Uu, Uu, Uu, Uu, Uu, Uu, Uu, Uu, Uu, Uu
Uu, Uu, Uu, Uu, Uu, Uu, Uu, Uu, Uu, Gs, Gg, Gs, Gs, Ce, Rrc, Rrc, Rrc, Rrc, Rr^Vhc, Rrc, Rrc, Rp^Vhcr, Rr, Rb, Gs^Vh, Gs^Vh, Gs^Vh, Gs^Vc, Gs^Vc, Ce, Hh, Wwg, Ss, Ww, Ww, Uu, Uu, Uu, Uu, Uu, Uu, Uu, Uu, Uu, Uu, Uu, Uu, Uu, Uu, Uu, Uu, Uu, Uu, Uu, Uu, Uu, Uu, Uu, Uu, Uu, Uu, Uu, Uu, Uu, Uu, Uu, Uu, Uu, Uu, Uu, Uu, Uu, Uu, Uu, Uu, Uu, Uu, Uu, Uu, Uu, Uu, Uu, Uu, Uu, Uu, Uu, Uu, Uu, Uu, Uu, Uu, Uu, Uu, Uu, Uu, Uu, Uu, Uu, Uu, Uu, Uu, Uu, Uu, Uu
Uu, Uu, Uu, Uu, Uu, Uu, Uu, Uu, Uu, Gs^Fms, Gs^Fms, Gs, Ce, Ce, Rrc, Rp^Vhcr, Rr^Vhc, Rr^Vhc, Gg, Rr^Vhc, Rr, Rrc, Rb, Gs^Vh, Rp^Vhcr, Gs^Vc, Gs^Vc, Gs^Vc, Gs^Vc, Ce, Gg, Gg, Hh, Ss, Gg, Uu, Uu, Uu, Uu, Uu, Uu, Uu, Uu, Uu, Uu, Uu, Uu, Uu, Uu, Uu, Uu, Uu, Uu, Uu, Uu, Uu, Uu, Uu, Uu, Uu, Uu, Uu, Uu, Uu, Uu, Uu, Uu, Uu, Uu, Uu, Uu, Uu, Uu, Uu, Uu, Uu, Uu, Uu, Uu, Uu, Uu, Uu, Uu, Uu, Uu, Uu, Uu, Uu, Uu, Uu, Uu, Uu, Uu, Uu, Uu, Uu, Uu, Uu, Uu, Uu, Uu, Uu, Uu, Uu
Uu, Uu, Uu, Uu, Uu, Uu, Uu, Uu, Uu, Gs, Gs, Gs, Ce, Rr, Rrc, Rr^Vhc, Rr^Vhc, Gg, Gg^Fet, Rrc, Rrc, Gs^Vh, Gs^Vc, Rb, Gs^Vh, Gs^Vh, Rb, Gd^Vhr, Gs^Vc, Ce, Ce, Hh, Gg, Gg, Hh, Uu, Uu, Uu, Uu, Uu, Uu, Uu, Uu, Uu, Uu, Uu, Uu, Uu, Uu, Uu, Uu, Uu, Uu, Uu, Uu, Uu, Uu, Uu, Uu, Uu, Uu, Uu, Uu, Uu, Uu, Uu, Uu, Uu, Uu, Uu, Uu, Uu, Uu, Uu, Uu, Uu, Uu, Uu, Uu, Uu, Uu, Uu, Uu, Uu, Uu, Uu, Uu, Uu, Uu, Uu, Uu, Uu, Uu, Uu, Uu, Uu, Uu, Uu, Uu, Uu, Uu, Uu, Uu, Uu
Uu, Uu, Uu, Uu, Uu, Uu, Uu, Uu, Uu, Gs, Gs, Gs, Rr, Rr, Rrc, Rr^Vhc, Rr^Vhc, Rr^Vhc, Rr^Vhc, Rrc, Gs^Vc, Rr, Gd^Vhr, Rb, Rb, Rb, Gs^Vc, Gs^Vh, Rb, Gs^Vc, Ce, Gs, Gg, Hh, Gs, Uu, Uu, Uu, Uu, Uu, Uu, Uu, Uu, Uu, Uu, Uu, Uu, Uu, Uu, Uu, Uu, Uu, Uu, Uu, Uu, Uu, Uu, Uu, Uu, Uu, Uu, Uu, Uu, Uu, Uu, Uu, Uu, Uu, Uu, Uu, Uu, Uu, Uu, Uu, Uu, Uu, Uu, Uu, Uu, Uu, Uu, Uu, Uu, Uu, Uu, Uu, Uu, Uu, Uu, Uu, Uu, Uu, Uu, Uu, Uu, Uu, Uu, Uu, Uu, Uu, Uu, Uu, Uu, Uu
Uu, Uu, Uu, Uu, Uu, Uu, Uu, Uu, Uu, Gs, Rr, Rr, Ce, Rr, Rrc, Rrc, Rrc, Rr^Vhc, Rrc, Rrc, Gs^Vh, Gs^Vh, Rr, Gs^Vh, Rb, Gs^Vc, Gd^Vhr, Gs^Vh, Rb, Gs^Vc, Ce, Gs, Hh, Gs, Gs, Uu, Uu, Uu, Uu, Uu, Uu, Uu, Uu, Uu, Uu, Uu, Uu, Uu, Uu, Uu, Uu, Uu, Uu, Uu, Uu, Uu, Uu, Uu, Uu, Uu, Uu, Uu, Uu, Uu, Uu, Uu, Uu, Uu, Uu, Uu, Uu, Uu, Uu, Uu, Uu, Uu, Uu, Uu, Uu, Uu, Uu, Uu, Uu, Uu, Uu, Uu, Uu, Uu, Uu, Uu, Uu, Uu, Uu, Uu, Uu, Uu, Uu, Uu, Uu, Uu, Uu, Uu, Uu, Uu
Uu, Uu, Uu, Uu, Uu, Uu, Uu, Uu, Uu, Rr, Rb^Gvs, Rb^Gvs, Ce, Rr, Rr^Vhc, Rr^Vhc, Rr, Rrc, Rp, Rr, Rb, Rb, Gd^Vhr, Gs^Vh, Rb, Gs^Vc, Rp, Gs^Vc, Gs^Vc, Gs^Vc, Ce, Gs, Gs, Gs, Hh, Uu, Uu, Uu, Uu, Uu, Uu, Uu, Uu, Uu, Uu, Uu, Uu, Uu, Uu, Uu, Uu, Uu, Uu, Uu, Uu, Uu, Uu, Uu, Uu, Uu, Uu, Uu, Uu, Uu, Uu, Uu, Uu, Uu, Uu, Uu, Uu, Uu, Uu, Uu, Uu, Uu, Uu, Uu, Uu, Uu, Uu, Uu, Uu, Uu, Uu, Uu, Uu, Uu, Uu, Uu, Uu, Uu, Uu, Uu, Uu, Uu, Uu, Uu, Uu, Uu, Uu, Uu, Uu, Uu
Uu, Uu, Uu, Uu, Uu, Uu, Uu, Uu, Uu, Rb^Gvs, Rb^Gvs, Rb^Gvs, Ce, Rr, Rr, Rr^Vhc, Rr^Vhc, Rp^Vhcr, Rr, Rr, Rb, Gs^Vc, Rp, Rb, Gs^Vc, Gs^Vh, Gs^Vc, Gs^Vh, Gs^Vc, Gs^Vc, Ce, Gs, Hh, Hh, Mm, Uu, Uu, Uu, Uu, Uu, Uu, Uu, Uu, Uu, Uu, Uu, Uu, Uu, Uu, Uu, Uu, Uu, Uu, Uu, Uu, Uu, Uu, Uu, Uu, Uu, Uu, Uu, Uu, Uu, Uu, Uu, Uu, Uu, Uu, Uu, Uu, Uu, Uu, Uu, Uu, Uu, Uu, Uu, Uu, Uu, Uu, Uu, Uu, Uu, Uu, Uu, Uu, Uu, Uu, Uu, Uu, Uu, Uu, Uu, Uu, Uu, Uu, Uu, Uu, Uu, Uu, Uu, Uu, Uu
Uu, Uu, Uu, Uu, Uu, Uu, Uu, Uu, Uu, Rb^Gvs, Rb^Gvs, Rb^Gvs, Rb^Gvs, Ce, Rr, Rr, Rr^Vhc, Rr, Rr^Vhc, Rp^Vhcr, Rb, Rb, Rb, Gd^Vhr, Rb, Rp^Vhcr, Gs^Vh, Gs^Vc, Rb, Ce, Hh, Hh, Gs, Mm, Mm, Uu, Uu, Uu, Uu, Uu, Uu, Uu, Uu, Uu, Uu, Uu, Uu, Uu, Uu, Uu, Uu, Uu, Uu, Uu, Uu, Uu, Uu, Uu, Uu, Uu, Uu, Uu, Uu, Uu, Uu, Uu, Uu, Uu, Uu, Uu, Uu, Uu, Uu, Uu, Uu, Uu, Uu, Uu, Uu, Uu, Uu, Uu, Uu, Uu, Uu, Uu, Uu, Uu, Uu, Uu, Uu, Uu, Uu, Uu, Uu, Uu, Uu, Uu, Uu, Uu, Uu, Uu, Uu, Uu
Uu, Uu, Uu, Uu, Uu, Uu, Uu, Uu, Uu, Rb^Gvs, Rb^Gvs, Rb^Gvs, Rb^Gvs, Ce, Ke, Rr, Rr, Rr, Rr^Vhc, Gs^Vh, Rb, Gs^Vh, Gs^Vc, Gs^Vc, Gs^Vh, Gs^Vh, Gs^Vc, Gs^Vc, Ce, Ce, Hh, Hh, Mm, Mm, Mm, Uu, Uu, Uu, Uu, Uu, Uu, Uu, Uu, Uu, Uu, Uu, Uu, Uu, Uu, Uu, Uu, Uu, Uu, Uu, Uu, Uu, Uu, Uu, Uu, Uu, Uu, Uu, Uu, Uu, Uu, Uu, Uu, Uu, Uu, Uu, Uu, Uu, Uu, Uu, Uu, Uu, Uu, Uu, Uu, Uu, Uu, Uu, Uu, Uu, Uu, Uu, Uu, Uu, Uu, Uu, Uu, Uu, Uu, Uu, Uu, Uu, Uu, Uu, Uu, Uu, Uu, Uu, Uu, Uu
Uu, Uu, Uu, Uu, Uu, Uu, Uu, Uu, Uu, Rb^Gvs, Rb^Gvs, Rb^Gvs, Rb^Gvs, Rb^Gvs, Ke, Ce, Ke, Rr, Rr, Rr, Re, Gs^Vc, Gs^Vc, Gs^Vc, Rb, Gs^Vc, Gs^Vc, Rb, Ce, Hh, Mm, Hh, Mm, Hh, Mm, Uu, Uu, Uu, Uu, Uu, Uu, Uu, Uu, Uu, Uu, Uu, Uu, Uu, Uu, Uu, Uu, Uu, Uu, Uu, Uu, Uu, Uu, Uu, Uu, Uu, Uu, Uu, Uu, Uu, Uu, Uu, Uu, Uu, Uu, Uu, Uu, Uu, Uu, Uu, Uu, Uu, Uu, Uu, Uu, Uu, Uu, Uu, Uu, Uu, Uu, Uu, Uu, Uu, Uu, Uu, Uu, Uu, Uu, Uu, Uu, Uu, Uu, Uu, Uu, Uu, Uu, Uu, Uu, Uu
Uu, Uu, Uu, Uu, Uu, Uu, Uu, Uu, Uu, Rd, Rb^Gvs, Rb^Gvs, Rb^Gvs, Rb^Gvs, Rb^Gvs, Ke, Rb^Gvs, Ce, Ce, Ce, Re, Ce, Ce, Ce, Ce, Ce, Ce, Ce, Rb^Gvs, Gs, Hh, Mm, Mm, Hh, Mm, Uu, Uu, Uu, Uu, Uu, Uu, Uu, Uu, Uu, Uu, Uu, Uu, Uu, Uu, Uu, Uu, Uu, Uu, Uu, Uu, Uu, Uu, Uu, Uu, Uu, Uu, Uu, Uu, Uu, Uu, Uu, Uu, Uu, Uu, Uu, Uu, Uu, Uu, Uu, Uu, Uu, Uu, Uu, Uu, Uu, Uu, Uu, Uu, Uu, Uu, Uu, Uu, Uu, Uu, Uu, Uu, Uu, Uu, Uu, Uu, Uu, Uu, Uu, Uu, Uu, Uu, Uu, Uu, Uu
Uu, Uu, Uu, Uu, Uu, Uu, Uu, Uu, Uu, Rb^Gvs, Rb^Gvs, Rb^Gvs, Rb^Gvs, Rb^Gvs, Rb^Gvs, Rb^Gvs, Rb^Gvs, Rb^Gvs, Rb^Gvs, Rb^Gvs, Re, Rb^Gvs, Rb^Gvs, Rb^Gvs, Rb^Gvs, Rb^Gvs, Rb^Gvs, Rb^Gvs, Rb^Gvs, Rb^Gvs, Gg, Hh, Hh, Hh, Mm, Uu, Uu, Uu, Uu, Uu, Uu, Uu, Uu, Uu, Uu, Uu, Uu, Uu, Uu, Uu, Uu, Uu, Uu, Uu, Uu, Uu, Uu, Uu, Uu, Uu, Uu, Uu, Uu, Uu, Uu, Uu, Uu, Uu, Uu, Uu, Uu, Uu, Uu, Uu, Uu, Uu, Uu, Uu, Uu, Uu, Uu, Uu, Uu, Uu, Uu, Uu, Uu, Uu, Uu, Uu, Uu, Uu, Uu, Uu, Uu, Uu, Uu, Uu, Uu, Uu, Uu, Uu, Uu, Uu
Uu, Uu, Uu, Uu, Uu, Uu, Uu, Uu, Uu, Rd, Uu, Rb^Gvs, Uu, Rb^Gvs, Uu, Rb^Gvs, Uu, Rb^Gvs, Uu, Rb^Gvs, Uu, Rb^Gvs, Uu, Rb^Gvs, Uu, Rb^Gvs, Uu, Rb^Gvs, Uu, Rb^Gvs, Uu, Hh^Gvs, Uu, Mm, Uu, Uu, Uu, Uu, Uu, Uu, Uu, Uu, Uu, Uu, Uu, Uu, Uu, Uu, Uu, Uu, Uu, Uu, Uu, Uu, Uu, Uu, Uu, Uu, Uu, Uu, Uu, Uu, Uu, Uu, Uu, Uu, Uu, Uu, Uu, Uu, Uu, Uu, Uu, Uu, Uu, Uu, Uu, Uu, Uu, Uu, Uu, Uu, Uu, Uu, Uu, Uu, Uu, Uu, Uu, Uu, Uu, Uu, Uu, Uu, Uu, Uu, Uu, Uu, Uu, Uu, Uu, Uu, Uu, Uu
Uu, Uu, Uu, Uu, Uu, Uu, Uu, Uu, Uu, Uu, Uu, Uu, Uu, Uu, Uu, Uu, Uu, Uu, Uu, Uu, Uu, Uu, Uu, Uu, Uu, Uu, Uu, Uu, Uu, Uu, Uu, Uu, Uu, Uu, Uu, Uu, Uu, Uu, Uu, Uu, Uu, Uu, Uu, Uu, Uu, Uu, Uu, Uu, Uu, Uu, Uu, Uu, Uu, Uu, Uu, Uu, Uu, Uu, Uu, Uu, Uu, Uu, Uu, Uu, Uu, Uu, Uu, Uu, Uu, Uu, Uu, Uu, Uu, Uu, Uu, Uu, Uu, Uu, Uu, Uu, Uu, Uu, Uu, Uu, Uu, Uu, Uu, Uu, Uu, Uu, Uu, Uu, Uu, Uu, Uu, Uu, Uu, Uu, Uu, Uu, Uu, Uu, Uu, Uu
Uu, Uu, Uu, Uu, Uu, Uu, Uu, Uu, Uu, Uu, Uu, Uu, Uu, Uu, Uu, Uu, Uu, Uu, Uu, Uu, Uu, Uu, Uu, Uu, Uu, Uu, Uu, Uu, Uu, Uu, Uu, Uu, Uu, Uu, Uu, Uu, Uu, Uu, Uu, Uu, Uu, Uu, Uu, Uu, Uu, Uu, Uu, Uu, Uu, Uu, Uu, Uu, Uu, Uu, Uu, Uu, Uu, Uu, Uu, Uu, Uu, Uu, Uu, Uu, Uu, Uu, Uu, Uu, Uu, Uu, Uu, Uu, Uu, Uu, Uu, Uu, Uu, Uu, Uu, Uu, Uu, Uu, Uu, Uu, Uu, Uu, Uu, Uu, Uu, Uu, Uu, Uu, Uu, Uu, Uu, Uu, Uu, Uu, Uu, Uu, Uu, Uu, Uu, Uu
Uu, Uu, Uu, Uu, Uu, Uu, Uu, Uu, Uu, Uu, Uu, Uu, Uu, Uu, Uu, Uu, Uu, Uu, Uu, Uu, Uu, Uu, Uu, Uu, Uu, Uu, Uu, Uu, Uu, Uu, Uu, Uu, Uu, Uu, Uu, Uu, Uu, Uu, Uu, Uu, Uu, Uu, Uu, Uu, Uu, Uu, Uu, Uu, Uu, Uu, Uu, Uu, Uu, Uu, Uu, Uu, Uu, Uu, Uu, Uu, Uu, Uu, Uu, Uu, Uu, Uu, Uu, Uu, Uu, Uu, Uu, Uu, Uu, Uu, Uu, Uu, Uu, Uu, Uu, Uu, Uu, Uu, Uu, Uu, Uu, Uu, Uu, Uu, Uu, Uu, Uu, Uu, Uu, Uu, Uu, Uu, Uu, Uu, Uu, Uu, Uu, Uu, Uu, Uu
