border_size=1
usage=map

Gg          , Gg          , Ss          , Gg          , Ss          , Ss          , Gg          , Gg          , Gg          , Gg          , Ss          , Ss          , Gg          , Gg          , Gg          , Wot         , Mm          , Mm          , Ha          , Ms          , Ms          , Mm          , Hh          , Gs          , Gs          , Gs          , Mm          , Ss          , Hh          , Mm          , Mm          , Mm          , Ww          , Ww          , Ww          , Wwf         , Rb          , Mm          , Mm          , Mm^Xm       , Md          , Md          , Md          , Gg          , Gg          , Gg^Eff      , Re^Eff      , Rd          , Rb          , Rb^Gvs      , Rb^Gvs      , Rb^Gvs      , Rb^Gvs      
Ss          , Ss          , Ww^Ewf      , Gg          , Gg          , Gg          , Gg          , Ss          , Gg          , Ss          , Gg          , Gg          , Gs          , Gg          , Gg          , Wwf         , Wo          , Mm          , Wo          , Ms          , Ms          , Ms          , Ha          , Hh          , Gs          , Gs          , Mm          , Hh          , Mm          , Mm          , Mm          , Hh^Fds      , Ms          , Mm          , Mm          , Gg          , Gg          , Mm          , Mm          , Mm^Xm       , Mm          , Md          , Gg          , Hh          , Gg          , Gg          , Gg          , Rd^Eff      , Re          , Re          , 1 Rd^Es     , 5 Rb        , Re          
Gg          , Ss          , Ss          , Ss          , Gg          , Gg^Em       , Ss          , Ss          , Gg          , Gg          , Gg          , Gs          , Gs          , Gs          , Rb^Gvs      , Gs          , Gg          , Wo          , Mm          , Mm          , Mm          , Ms          , Mm          , Hh          , Gs          , Mm          , Mm          , Mm          , Mm          , Mm          , Hh          , Mm          , Hh          , Hh          , Hh          , Hh          , Gs          , Hh^Vhh      , Hh          , Mm          , Mm          , Md          , Md          , Hh          , Hh          , Gg          , Gg          , Gg          , Gs^Vh       , Re          , Re          , Rb^Gvs      , Re          
Gg          , Gg          , Ss          , Ss          , Gg          , Ss          , Gg          , Gg          , Gg          , Gg          , Gg          , Gg          , Rb^Gvs      , Rb^Gvs      , Rb^Gvs      , Rb^Gvs      , Rb^Gvs      , Gs^Vh       , Hh          , Mm          , Mm          , Mm          , Gs          , Hh          , Gs^Es       , Gs          , Gs          , Gs          , Gs          , Gs          , Gs          , Gs          , Gs          , Gs          , Gg          , Hh          , Gs          , Gs          , Hh          , Hh          , Hh          , Hh          , Md          , Hh          , Hh          , Gg          , Gg          , Gg          , Gg          , Re^Gvs      , Re          , Re          , Gs^Gvs      
Ss          , Ss          , Ss          , Gg          , Gs          , Gg^Efm      , Ss          , Gg          , Ss          , Gg          , Gg          , Rb^Gvs      , Rb^Gvs      , Re          , Re          , Rb^Gvs      , Rb^Gvs      , Rb^Gvs      , Hh          , Mm          , Hh          , Gs          , Gs          , Gs          , Gs          , Gs          , Gs          , Gs          , Gs          , Gs          , Gs          , Gg          , Gg          , Gg          , Gg          , Gg          , Gg^Efm      , Gs          , Gs          , Hh          , Gs          , Hh          , Hh          , Mm          , Mm          , Mm          , Hh          , Gs          , Gg          , Re          , Re          , Rb          , Gs          
Wot         , Wot         , Ww          , Gg          , Gg          , Ds          , Ss          , Gg          , Ss          , Gg          , Gg          , Gg          , Gg          , Rb^Gvs      , Gs          , Gg          , Gg          , Hh          , Hh          , Hh          , Gs          , Gs          , Gs          , Gs          , Gs          , Gs          , Gs          , Gs          , Gg          , Gs          , Gs          , Gg          , Gg          , Gg          , Gg          , Gg          , Gs          , Gg          , Gs          , Gs          , Gg          , Gs          , Gg          , Hh          , Mm          , Mm          , Gg          , Gg          , Gg          , Gs          , Gs          , Re          , Re          
Ww          , Gg          , Ss          , Gg^Efm      , Ss          , Ss          , Ds          , Ss          , Ww          , Gg          , Gg          , Gg          , Gg          , Gg          , Gg          , Gg          , Gg          , Gs          , Gs          , Gs          , Gs          , Gs          , Gs          , Gs^Es       , Gs          , Gs          , Gs          , Gs          , Gg          , Gg          , Gg          , Gg          , Ww          , Gg          , Gg          , Gs          , Gg^Es       , Gs^Es       , Gs^Es       , Gs          , Gs          , Gs^Es       , Gs          , Gs          , Gs          , Hh          , Gg          , Gg          , Gg          , Gs          , Gs          , Rd^Es       , Re          
Ss          , Gg          , Ss          , Ss          , Gg^Efm      , Ds          , Ww          , Ww          , Wot         , Wot         , Wot         , Gg          , Gg          , Gg          , Gg          , Gg          , Gg          , Gg          , Gg          , Gs          , Gs          , Gs          , Gs          , Gs          , Gs          , Gs          , Gs          , Gs          , Gs          , Gg          , Rb^Gvs      , Rb^Gvs      , Rb^Gvs      , Gs^Fds      , Gg          , Gs          , Gs          , Gg          , Gs          , Gs          , Gg^Efm      , Hh          , Hh^Fp       , Gs          , Gg          , Gg          , Gg          , Gg          , Gs          , Rd          , Gg          , Gg          , Gg          
Ds          , Ss          , Sm          , Ds          , Ds          , Wwf         , Wot         , Wot         , Gg^Efm      , Ss          , Gg          , Gg          , Gg          , Gg          , Gs          , Gg          , Gs          , Gg          , Gg          , Gs          , Gs          , Gs          , Gs          , Gs          , Gs          , Gs          , Gs          , Gs          , Gs          , Gg          , Gg          , Rb^Gvs      , Gg          , Gs^Vh       , Gg          , Gg          , Hh          , Hh          , Hh          , Hh          , Mm          , Hh^Efm      , Gs          , Hh          , Gs          , Gs          , Gs          , Gs          , Gs          , Gs          , Gs          , Gg          , Gg          
Ww          , Ss^Vhs      , Gg^Efm      , Ss          , Wwf         , Wwf         , Ss          , Wot         , Ss          , Ss          , Gg          , Gg          , Gg          , Gg          , Gg          , Gs          , Gs          , Gg          , Gs          , Gs          , Gs          , Gs^Es       , Gs          , Gs          , Gs          , Gs          , Gs          , Gs          , Gs          , Gs          , Gs          , Gg          , Gg^Efm      , Gg          , Hh          , Gs          , Hh          , Gg^Efm      , Hh          , Mm          , Hh          , Gs          , Gs          , Gs          , Gs          , Gs          , Gs          , Gs          , Gs          , Gs          , Gs          , Gs          , Gg          
Wot         , Ww          , Ww          , Ww          , Wot         , Ww          , Wot         , Wot         , Wwf         , Gg          , Gg          , Ss          , Gg          , Gg          , Gg          , Gg          , Gg          , Gg          , Gs          , Gs          , Gs          , Gs          , Gs          , Gs          , Gs          , Gs          , Gs          , Hh          , Gs          , Gs          , Gs          , Gs          , Gg          , Gs^Es       , Gg          , Hh          , Gs          , Gs          , Gs          , Hh          , Gs          , Gs          , Gs          , Gs          , Gs          , Gs          , Gs          , Gs          , Gs          , Gs          , Gs          , Gs          , Gg          
Wot         , Ww          , Wot         , Ww          , Wot         , Wot         , Ww          , Wot         , Gg          , Gg          , Ss          , Gg          , Gg          , Gg          , Gg          , Gg          , Gg          , Gs          , Gs          , Gs          , Gs          , Gs          , Gs          , Gs          , Gs          , Gs          , Gs          , Gs          , Gs          , Gs          , Gs          , Gs          , Ce          , Gs          , Gs          , Gs          , Gs          , Gs          , Gs          , Gs          , Hh          , Hh          , Gs          , Gs          , Hh          , Gs          , Gs          , Gs          , Gs          , Gs          , Gs          , Gs          , Gd          
Gg          , Wot         , Wot         , Wot         , Ss          , Ww          , Gg          , Ss          , Gg          , Gg          , Ss          , Gg          , Gg          , Gg          , Gg          , Gg          , Gs          , Gg          , Gg          , Gs          , Gs          , Gs          , Gg          , Gs          , Gs          , Gs          , Gs          , Hh          , Hh          , Gg          , Gs          , Ce          , 2 Ke        , Ce          , Gs          , Gs          , Gs          , Gs          , Gs          , Gs          , Gs          , Gs          , Gs          , Gs          , Hh          , Hh          , Hh          , Gs          , Gs          , Hh          , Hh          , Hh          , Hh          
Gg          , Ss          , Ss          , Ss          , Ss          , Gg^Efm      , Gg          , Hh          , Gg          , Ss          , Ss          , Gg          , Gg          , Gg          , Gg          , Gg          , Gg          , Gg          , Gs          , Gg          , Gg          , Gg          , Gs          , Gs          , Gg          , Gs          , Rd          , Rd          , Gd^Vhr      , Gs          , Gg          , Gs          , Gg          , Gg^Efm      , Gs          , Gs          , Gs          , Gs          , Gs          , Gs          , Gs          , Hh          , Gs          , Gs          , Hh          , Hh          , Gs          , Hh          , Hh          , Hh          , Gs          , Gs          , Gs          
Gg          , Ss          , Ss          , Gg          , Gg          , Gg          , Gg          , Gs^Vc       , Gg          , Rb^Gvs      , Gg          , Gg          , Gs          , Gg          , Gg          , Gg          , Gg          , Gg          , Hh          , Gs          , Gs          , Gg          , Gs          , Gg          , Gs          , Hh          , Rd          , Rd          , Gs          , Gs          , Gs          , Gs          , Gs          , Gs          , Gg          , Gs          , Gs          , Gs          , Mm          , Hh          , Gs^Es       , Gs          , Hhd^Vhhr    , Hh          , Hh          , Hh          , Gs          , Hh          , Mm          , Hh          , Hh          , Hh          , Mm          
Gg          , Ss          , Sm          , Ss          , Gg          , Ss          , Ss          , Gg          , Gg^Emf      , Ss          , Gg          , Gg          , Gg          , Gs          , Gg          , Gg          , Gg          , Gg          , Mm          , Hh          , Gg          , Gg          , Gg          , Gs          , Gs          , Gs          , Gs          , Gs          , Gg          , Gs          , Gs          , Gs          , Gs          , Gs          , Gs          , Gg          , Gs          , Gs          , Gs          , Gs          , Gs          , Hh          , Mm          , Hh          , Gll^Fp      , Hh          , Mm          , Gs          , Mm          , Mm          , Mm          , Mm          , Mm          
Gg          , Ss          , Gg          , Ss          , Gg^Em       , Gg          , Ww          , Ss          , Ss          , Ss          , Gg          , Gg          , Gg          , Gg          , Gg          , Gs          , Gs          , Hh          , Hh          , Hh^Fp       , Gg          , Gg          , Gg          , Gg          , Gg          , Gs          , Gs          , Gs          , Gs          , Gs          , Gs          , Gs          , Gs          , Gg          , Hh          , Gs          , Gg          , Gs          , Gs          , Gs          , Hh          , Hh          , Mm          , Mm          , Mm          , Mm          , Mm          , Mm          , Hh          , Hh          , Hh          , Mm          , Hh          
Ww          , Wot         , Wot         , Sm          , Gg          , Ss          , Wot         , Gg          , Ss          , Gg          , Gg          , Gg          , Gg          , Gg          , Gg          , Gg          , Gg          , Hh          , Gs          , Gs^Vh       , Rb^Gvs      , Gg          , Gg          , Gg          , Gg          , Gs          , Gs          , Gs          , Gs          , Gs          , Gs          , Gs          , Gg          , Gs          , Gg          , Gg          , Gg          , Hh          , Hh          , Gg          , Gg          , Mm          , Ms          , Mm          , Ms          , Mm          , Hh          , Hh          , Gs          , Hh          , Hhd         , Hh          , Gs          
Ss          , Wot         , Ww          , Ds          , Gg          , Wot         , Ss          , Gg          , Ww          , Ss          , Gg          , Ss          , Gg          , Gg          , Gg          , Gs          , Gg          , Gs          , Rb^Gvs      , Rb^Gvs      , Rb^Gvs      , Gg          , Gs          , Gg          , Gs          , Gs          , Gs          , Gs          , Gs          , Gs          , Gs          , Gg          , Gs          , Gs          , Gs          , Gs          , Gg          , Hh          , Hh          , Hh^Fp       , Gs^Vh       , Ww          , Mm          , Hh^Fp       , Mm          , Mm          , Mm          , Gs          , Gs          , Gs          , Gs          , Gd          , Gd          
Ss          , Ss          , Sm          , Ww          , Ww          , Gg          , Sm          , Gg          , Ss          , Ww          , Ss          , Gg          , Gg          , Gg          , Gg          , Gg          , Gg          , Gg          , Gg          , Rb^Gvs      , Gg          , Gg          , Gs          , Gs          , Gs          , Gg          , Gg          , Gs          , Gs          , Gs          , Gs          , Gs          , Gg          , Gs          , Gg          , Gs          , Hh          , Hh          , Hh          , Rb^Gvs      , Rb^Gvs      , Hh          , Hh^Fp       , Mm          , Hh          , Mm          , Mm          , Hh          , Hh          , Gd          , Gg          , Gd          , Gd          
Ww          , Ss          , Wot         , Ss          , Ww          , Ss          , Ss          , Ww          , Ss          , Wot         , Gg          , Gg          , Ss          , Ss          , Gg          , Gg          , Gg          , Gg          , Gg          , Gg          , Gg          , Gs          , Gg          , Gs          , Gs          , Gs          , Gs          , Gs          , Gs          , Gs          , Gs          , Gg          , Gg          , Gs          , Gs          , Gg          , Gs          , Gs          , Gs          , Gg          , Hh          , Gs          , Hh          , Hh          , Gs          , Mm          , Mm          , Hh          , Gs^Vh       , Hh          , Rb^Gvs      , Gg          , Gd          
Wot         , Wot         , Wot         , Ww          , Wot         , Gg          , Gg          , Ss          , Gg          , Gg          , Ss          , Gg          , Gg          , Gg          , Gg          , Gg          , Gg          , Gs          , Gg          , Gg          , Gg          , Gg          , Gg          , Gs          , Gs          , Gg          , Gs          , Gs          , Gs          , Gs          , Gs          , Gs          , Gs          , Gs          , Gs          , Gs          , Gs          , Gs          , Gs          , Gs          , Hh          , Hh          , Hh          , Hh          , Hh          , Mm          , Hh          , Hh          , Hh          , Rb^Gvs      , Rb^Gvs      , Gs          , Gs          
Ww          , Wot         , Ww          , Ww          , Ww          , Sm          , Ww          , Ss          , Ss          , Gg          , Gg^Efm      , Gg          , Gg          , Gg          , Gg          , Gg          , Gg          , Gg          , Gg          , Gg          , Gg          , Gg          , Gg          , Gg          , Gs          , Gs          , Rb^Gvs      , Gs          , Gs          , Gs          , Gs          , Gs          , Gs          , Gs          , Gs          , Gs          , Gs          , Gs          , Gs          , Gs          , Gs          , Gs          , Gs          , Hh          , Hh          , Mm          , Hh          , Hh          , Hhd^Fdw     , Hh          , Gs          , Gs          , Gs          
Ss          , Gg          , Ss          , Gg          , Ww          , Gg          , Gg          , Ww          , Wot         , Ww          , Ss          , Ss          , Ss^Vhs      , Ss          , Gg          , Gg          , Gg          , Gg          , Gg          , Gs          , Gs          , Gg          , Gg          , Gs          , Gs          , Gs          , Gs          , Gs^Vh       , Hh          , Gs          , Gs          , Gs          , Hh          , Gs          , Hh          , Gs          , Gs          , Gs          , Gs          , Gs          , Gd          , Gs^Es       , Gs          , Hh          , Hh          , Mm          , Hh          , Hhd         , Hhd^Fdw     , Gs          , Gs          , Gs          , Gd          
Gg          , Gg          , Gg          , Ww          , Gg          , Ww          , Gg          , Ss          , Wot         , Sm          , Ww          , Ss          , Gg          , Gg          , Gg          , Gg          , Gg          , Gg          , Gs          , Gs          , Gs          , Gs          , Gg          , Gg          , Gg          , Gs          , Gs          , Gs          , Gs          , Hh          , Gs          , Gs          , Gs          , Hh          , Hh          , Gs          , Gs          , Gs          , Gs          , Gs          , Gd          , Gs          , Gs          , Hh          , Gs          , Hh          , Gd          , Gd          , Gd          , Gd          , Gd^Es       , Gd          , Gd          
Hh          , Hh          , Ww          , Ww          , Ss          , Ss          , Ww          , Ww          , Sm          , Gg          , Gg          , Ss          , Gg          , Gg          , Gg          , Gg          , Gg          , Gg          , Gg          , Gg          , Gg          , Gs          , Gs^Es       , Gs          , Gs          , Gs          , Gg          , Gs          , Gs          , Gs          , Gs          , Gs          , Hh          , Hh          , Md          , Hh          , Gs          , Gs          , Hh          , Gs          , Gs          , Gd          , Gd^Es       , Gs          , Gd          , Gs          , Gd          , Gd          , Gd          , Gd          , Gd          , Gd^Edp      , Gd          
Gs          , Gg          , Gg          , Gg          , Gg          , Gg          , Ss          , Gg          , Ss          , Gg          , Gg          , Gg          , Gg          , Gg          , Gg          , Gg          , Gs          , Gg          , Gs          , Gg          , Gs          , Gg          , Gs          , Gs          , Gs          , Gs          , Gs          , Gs          , Gs          , Gs          , Hh          , Hh          , Hh          , Md          , Hh          , Gs          , Hhd         , Hh          , Rd          , Hhd         , Gs          , Gs          , Gs          , Gs          , Gs          , Gs          , Gs          , Gd          , Gd^Es       , Gd          , Gs          , Hhd         , Gs          
Mm          , Hh          , Hh          , Hh          , Hh          , Gg          , Rb^Gvs      , Gg          , Gg          , Gg          , Gg          , Gg          , Gg          , Gg          , Gg          , Gs          , Gg          , Gg          , Gs          , Gg          , Gs          , Gs          , Gs          , Gs          , Gs          , Gs          , Gs          , Gs          , Gs          , Gs          , Hh          , Gs          , Gs          , Hh          , Gs          , Gs          , Re          , Gd^Vhr      , Hh          , Hhd         , Gs          , Gd          , Gs          , Gs          , Gd          , Gs          , Gs          , Gs          , Gs          , Gs          , Gs          , Gs          , Hhd         
Md          , Mm          , Mm          , Hh          , Hh          , Gs^Vh       , Rb^Gvs      , Gg          , Gs          , Gg          , Gg          , Gs          , Gs          , Gg          , Gs          , Gs          , Gs          , Gs          , Gs          , Gs          , Gs          , Gs          , Gs          , Gs          , Gs          , Gs          , Hh          , Gs          , Gs          , Gs          , Hh          , Gs          , Gs          , Gs          , Gs          , Gs          , Hh          , Hh          , Gd          , Gs          , Hhd^Fmw     , Hhd         , Gs          , Gs          , Gs          , Gs          , Hh          , Gs          , Hhd         , Hhd         , Hhd         , Hhd         , Hhd         
Hh          , Hh          , Hh          , Md          , Gg          , Hh          , Gg          , Gg          , Gs          , Gg          , Gs          , Gs          , Gs          , Gg          , Gs          , Gs          , Gs          , Gs          , Gs          , Gs          , Gs          , Gs          , Gs          , Gs          , Gs          , Hh          , Gs          , Hh          , Gs          , Hh          , Gs          , Hh          , Gs          , Gs          , Gs          , Gs          , Gd          , Hh          , Gs          , Hh          , Gs          , Gs          , Gs          , Gs          , Hh          , Hhd         , Gs          , Hh          , Hh          , Gs          , Gs          , Hhd         , Gd          
Gs          , Hhd         , Gs          , Hhd         , Hh          , Hh          , Gg          , Gs          , Gs          , Gs          , Gs          , Gs          , Gs          , Gg          , Gs^Es       , Gs          , Gs          , Gs          , Gs^Es       , Gs          , Gs          , Gs          , Gs          , Gs          , Gs          , Gs          , Gs          , Gs          , Gs          , Gd          , Gs          , Hh          , Hhd         , Md          , Hh          , Gs          , Gs          , Gs          , Gs          , Gs          , Gd          , Gs          , Hh          , Hhd         , Hh          , Gs          , Gs          , Gs          , Hhd         , Hh          , Hhd         , Gs          , Hh          
Re          , Re          , Rd          , Gs          , Gs          , Hhd         , Gs          , Gs          , Gs          , Gs          , Gs          , Gs          , Gs          , Gs          , Gs          , Gs          , Gs          , Gs          , Gs          , Gs          , Gs          , Gs          , Gs          , Gs          , Hh          , Gs          , Hh          , Gd          , Hh          , Gs          , Gd          , Hh          , Gd          , Gs          , Hh          , Hh          , Hh          , Hhd         , Hh          , Gs          , Hh          , Hh          , Hhd         , Hhd         , Mm          , Gs          , Gs          , Gs          , Hhd         , Hhd         , Gd          , Hhd         , Gs          
Gs          , Hhd         , Hhd         , Re          , Rd          , Gs          , Gs          , Gs          , Hh          , Gs          , Gs          , Gs          , Gs          , Gs          , Gs          , Gs          , Gs          , Gs          , Gs          , Gs          , Gd          , Gs          , Hh^Vhh      , Hh          , Gs          , Hh          , Gs          , Hhd         , Hhd         , Gs          , Gs          , Gs          , Gs          , Gs          , Gs          , Gs          , Hhd         , Hhd         , Gs          , Gs          , Gd          , Gd          , Hh          , Mm          , Hh          , Hhd         , Hhd         , Gs          , Gs          , Gd^Es       , Gd          , Hhd         , Gd          
Hhd         , Gs          , Hhd         , Gs          , Hhd         , Rd          , Co          , Hh          , Hhd         , Hhd         , Hh          , Gs          , Gs          , Gs          , Gg          , Gd          , Gg          , Gs          , Gs          , Hh          , Hh          , Hh          , Gd          , Hhd         , Hhd         , Gs          , Gd          , Gs          , Gd          , Gs          , Gd          , Gs          , Gs          , Gs          , Gd          , Gd          , Gs          , Gs          , Gd          , Gs          , Hhd         , Hh          , Mm          , Hh          , Co          , Mm          , Mm          , Hhd         , Gs          , Gd          , Hhd         , Hhd         , Hhd         
Hhd         , Hhd         , Gs          , Gd^Vo       , Gs          , Co          , Ko          , Co          , Md          , Hh          , Hhd         , Gd          , Gd          , Gs          , Gs          , Gg          , Hh          , Hh          , Hh          , Hh          , Hh          , Hh          , Gd          , Hh          , Hhd         , Hhd         , Gd          , Gd^Es       , Gd          , Gd          , Gd          , Gd          , Gd          , Gd^Es       , Gd          , Gs          , Gs          , Hhd         , Hhd         , Hh          , Hhd         , Hhd         , Md          , Co          , Co          , Co          , Mm          , Hhd^Fmw     , Hh          , Gs          , Gs          , Hhd         , Hhd         
Md          , Hhd         , Md          , Md          , Md          , Md          , Md          , Gs          , Hh          , Md          , Hhd         , Hhd         , Hhd         , Gs          , Gd^Es       , Gs          , Gd^Es       , Hh          , Gs          , Gs          , Gs          , Gd          , Hhd         , Hh          , Hhd         , Gd          , Gd          , Hhd         , Hhd         , Gd          , Hhd         , Hhd         , Gd          , Gd          , Gs          , Gd^Vo       , Hh          , Md          , Md          , Md          , Mm          , Mm          , Hh          , Hhd         , Md          , 3 Ko        , Mm          , Md          , Md          , Gd^Vo       , Hhd         , Gs          , Hhd         
Hhd         , Md          , Md          , Hh          , Mm          , Mm          , Md          , Md          , Md          , Md          , Hhd         , Gs          , Md          , Hhd         , Hhd         , Gd          , Gs          , Gs          , Gd          , Gd          , Gd^Es       , Gd          , Hhd         , Md          , Hhd         , Hd          , Gs          , Hhd         , Mm          , Hhd         , Hhd         , Gd          , Gd          , Gd          , Gs          , Hhd         , Hhd         , Mm          , Mm          , Mm          , Mm          , Hh          , Md          , Md          , Hhd         , Hhd         , Hhd         , Md          , Hh          , Hhd^Fdw     , Hhd         , Hh          , Md          
Gs          , Md          , Gd          , Md          , Gs          , Md          , Hhd         , Hhd         , Gs          , Md          , Hhd         , Hhd         , Md          , Md          , Hh          , Hh          , Hh          , Gd          , Gd          , Hhd         , Gd          , Hhd         , Gd          , Gd^Edpp     , Gd          , Gs          , Hhd         , Hhd         , Md          , Mm          , Hhd         , Hhd         , Gd          , Gs          , Gs          , Hh          , Mm          , Mm          , Hhd         , Hh          , Mm          , Md          , Md          , Hhd         , Gd          , Gd          , Gd          , Md          , Mm          , Md          , Gs          , Mm          , Md          
