border_size=1
usage=map

Hh          , Gs          , Hh          , Gg          , Gg          , Gg          , Gs          , Gg          , Rrc         , Rr          , Gg          , Gg          , Hh          , Hh          , Hh          , Gg          , Ww          , Ww          , Gg          , Gg          , Gg          , Gg          
Gs          , Hh          , Gg          , Gs          , Gs          , Gs          , Gs          , Gs          , Rr          , Rrc         , Gg          , Gs          , Gg          , Gg          , Gg          , Gg          , Wo          , Ww          , Gg          , 1 Gg        , Gg          , Gg          
Hh          , Hh          , Gs          , Gs          , Gs          , Gg          , Gg          , Gs          , Rrc         , Rrc         , Gs          , Gg          , Hh          , Gs          , Gg          , Gg          , Ww          , Ww          , Gg          , 2 Gg        , Gs          , Gg          
Gg          , Gs          , Gs^Es       , Gs          , Gs          , Gs          , Gs          , Gg          , Rrc         , Rrc         , Gs          , Gs          , Gg          , Gs          , Gg          , Gg          , Ww          , Ww          , Gg          , 4 Gg        , Gg          , Gg          
Gg          , Gs          , Gs          , Gs          , Gg          , Gs          , Gs          , Gg          , Rrc         , Rrc         , Gs          , Gs          , Gg          , Gg          , Gg          , Ww          , Wo          , Wo          , Gg          , Gg          , Gg          , Gs          
Hhd         , Gs          , Gs          , Gg          , Gs          , Gg          , Gs          , Gg          , Rrc         , Rrc         , Gs          , Gs          , Gg          , Gs          , Gg          , Ww          , Wo          , Gg          , Gg          , Gg          , Gg          , Gs          
Gd^Edp      , Gs          , Gs          , Gg          , Gs          , Gg          , Gs          , Gs          , Rrc         , Rrc         , Gs          , Gg          , Gg          , Gs          , Gg          , Ww          , Ww          , Gg          , Gg          , Gg          , Gg          , Gs          
Gg          , Gs          , Gs          , Gs          , Gs          , Gs          , Gs          , Gg          , Rrc         , Rrc         , Gg          , Gs          , Gg          , Gg          , Gg          , Ww          , Ww          , Gg          , Gg          , Gs          , Gg          , Gg          
Gg          , Gd          , Gs          , Gs          , Gs          , Gg          , Gs          , Gs          , Rrc         , Rrc         , Gg          , Gs          , Gs          , Gg          , Gg          , Ww          , Ww          , Gg^Efm      , Gg          , Gg          , Gg          , Gg          
Gd          , Gs          , Gs          , Gs          , Gs          , Gg          , Gs          , Gg          , 8 Rrc       , Rrc         , Gg          , Gg          , Gg          , Gg          , Gs^Vh       , Gg          , Wo          , Ww          , Gg          , Gg          , Gg          , Gg          
Gd^Edpp     , Gs^Es       , Gs          , Gs          , Gg          , Gg          , Gs          , Gg          , Rrc         , 3 Rrc       , Gs          , Gs          , Gs          , Gg          , Gg          , Gg          , Wo          , Ww          , Ww          , Gg          , Gg          , Gg          
Gd^Edp      , Gs          , Gs          , Gs          , Gs          , Gg          , Gg          , Gs          , Rrc         , Rrc         , Gs          , Gs          , Gs          , Gg          , Gg          , Gg          , Gg          , Ww          , Ww          , Ss          , Gg          , Gg^Efm      
Hhd         , Gs          , Gs          , Gs^Es       , Gg          , Gg          , Gg          , Gs          , Rrc         , Rrc         , Gs          , Gg          , Gg          , Gg          , Gg          , Gg          , Gg          , Ww          , Wo          , Ww          , Ww          , Gg          
Gg          , Gs          , Gg          , Gg          , Gg          , Gg          , Gg          , Gg          , Rrc         , Rrc         , Gg          , Gs          , Gg          , Gg          , Gg          , Gg          , Gg          , Gg          , Gg          , Wo          , Ww          , Ww          
