border_size=1
usage=map

Gg          , Gg          , Gs          , Gd          , Gd          , Gd          , Gs          , Gs          , Gd          , Gd          , Gd          , Gd^Es       , Hhd         , Hhd         , Hhd         , Gg          , Md          , Md          , Hhd         , Md          , Md          , Md          , Md          , Md          , Md          , Md          , Md          , Mm          , Md          , Md          , Hhd         , Hhd         , Hhd         , Gd          , Hhd         , Gd          , Gd          , Gd          , Gd^Edpp     , Gd          , Gd          , Gd          , Gd          , Gd          , Gd          , Gd          , Gd          , Gd          , Gd^Es       , Gd          , Gd          , Gs          
Gd^Vo       , Gs          , Gg          , Gs          , Gs          , Gs^Es       , Gd          , Gd          , Gd          , Gd          , Gd          , Gd^Edpp     , Hhd         , Gd^Es       , Gs          , Mm          , Md          , Mm          , Hhd         , Mm          , Md          , Md          , Mm          , Md          , Mm          , Md          , Md          , Md          , Md          , Md          , Hhd         , Gs          , Hhd         , Md          , Hhd         , Gd          , Gd          , Hhd         , Gd          , Gd          , Hhd         , Gd          , Rd          , Gd          , Gd          , Gd^Es       , Gd          , Gd          , Gd          , Gd          , Gd          , Hhd         
Gg          , Gg          , Gg          , Gg          , Gg          , Gs          , Gd          , Gs          , Gs          , Gd^Es       , Gd          , Gd          , Gs          , Hhd         , Hhd         , Md          , Md          , Md          , Mm          , Md          , Hhd         , Hhd         , Md^Xm       , Mm          , Hhd         , Mm          , Wo          , Mm          , Md          , Mm          , Md          , Md          , Gd          , Md          , Gd          , Hhd         , Gd          , Gd          , Hhd         , Gd          , Hhd         , Gd^Vhr      , Gd          , Gd          , Gd          , Gd          , Gs          , Gd          , Rd          , Gs          , Gd          , Gd          
Wo          , Gg          , Gg          , Gg          , Gg          , Gg          , Gd          , Gd          , Gs          , Gd          , Gd          , Gd          , Gd          , Hhd         , Gs          , Md          , Mm          , Mm          , Hhd         , Gd          , Md^Xm       , Md^Xm       , Md          , Md          , Mm          , Hh          , Gs          , Md          , Md          , Md          , Gd          , Gd          , Hhd         , Gd          , Hhd         , Gd          , Hhd         , Hhd         , Hhd         , Hhd         , Md          , Hhd         , Hhd         , Gd          , Gd          , Gd          , Gd          , Gd          , Gd          , Rd^Edp      , Gd          , Gs          
Ww          , Wo          , Wo          , Wo          , Wo          , Gg          , Gs          , Gs          , Gg          , Gs          , Gs          , Gs          , Gd          , Gd          , Gs          , Hhd         , Md          , Hhd         , Hhd         , Md^Xm       , Mm          , Md          , Md          , Md          , Md          , Hhd         , Mm          , Md          , Gd          , Hhd         , Hhd         , Gd          , Gd^Vhr      , Hhd         , Gd          , Hhd         , Hhd         , Gd          , Md          , Md          , Md          , Md          , Gd          , Gs          , Gs          , Gs          , Gd          , Gd          , Gd          , Gd          , Gd          , Gd          
Gg          , Ww          , Gg          , Wo          , Ww          , Wo          , Ww          , Gg          , Ww          , Gg          , Ww          , Gs          , Gs          , Gd          , Gs          , Gd^Es       , Gd^Vo       , Gd          , Md^Xm       , Mm^Xm       , Hhd         , Md          , Gs          , Mm          , Hhd         , Mm          , Gs          , Hhd         , Gd          , Md          , Md          , Gd          , Md          , Mm          , Mm          , Mm          , Md          , Mm          , Md          , Md          , Md          , Md          , Hhd         , Hhd         , Hhd         , Hhd         , Hhd         , Gd          , Gs          , Gd          , Gs          , Gd          
Rb          , Gg          , Gg          , Gg          , Gg          , Ww          , Wo          , Ww          , Wo          , Ww          , Ww          , Ww          , Gg          , Gs          , Gd          , Gd          , Hhd         , Hhd         , Md^Xm       , Md          , Md          , Md          , Hhd         , Hhd         , Md          , Hhd         , Hhd         , Hhd         , Hhd         , Md          , Md          , Md          , Md          , Md          , Md          , Md          , Md          , Md          , Md          , Md          , Hhd         , Hhd         , Gd          , Gd          , Gd          , Gd          , Gd          , Gd          , Gd^Es       , Gd          , Gd          , Gd          
Gg          , Rb          , Rb          , Hh          , Hh          , Gg          , Gg          , Wo          , Gg          , Ss          , Gg          , Ww          , Ww          , Gs          , Gs          , Gs          , Mm^Xm       , Md^Xm       , Md          , Md          , Hhd         , Hhd         , Md          , Md          , Md          , Md          , Md          , Md          , Md          , Md          , Md          , Gs          , Md          , Mm          , Mm          , Hhd         , Mm          , Md          , Mm          , Hhd         , Gd^Es       , Gd^Es       , Gd          , Gd          , Gd          , Gd          , Gd          , Gs          , Gd          , Gd          , Gd          , Rd          
Gd          , Hh          , Hh          , Rb          , Hh          , Gd          , Gg          , Gg          , Gd^Vo       , Gg          , Gg          , Wo          , Wo          , Ww          , Gg          , Hh          , Mm^Xm       , Md          , Mm^Xm       , Md^Xm       , Mm^Xm       , Md          , Mm^Xm       , Md          , Md^Xm       , Md^Xm       , Mm^Xm       , Mm^Xm       , Md^Xm       , Md^Xm       , Mm^Xm       , Md          , Md^Xm       , Md          , Md          , Mm          , Mm          , Mm          , Hhd         , Hhd         , Hhd         , Gs          , Gd          , Hhd         , Gd          , Gd^Es       , Gd          , Gd          , Gd          , Gs          , Gd          , Rd          
Hhd         , Hhd         , Gd          , Re          , Re          , Gd          , Hhd         , Hh          , Hh          , Hh          , Gs          , Gg          , Wo          , Ww          , Wo          , Hh          , Mm^Xm       , Mm^Xm       , Hh          , Hh          , Hh          , Mm^Xm       , Hh          , Mm^Xm       , Hh          , Hh          , Hh          , Hh          , Hh          , Hh          , Hh          , Mm^Xm       , Gs          , Md^Xm       , Mm^Xm       , Md^Xm       , Mm^Xm       , Hhd         , Hhd         , Hhd         , Gd          , Gd          , Hhd         , Hhd         , Gd          , Gd          , Gs          , Gd          , Gd          , Gd          , Gd          , Gd^Vhr      
Gd          , Gd          , Gd          , Hhd         , Gd^Es       , Rd          , Re          , Gs          , Gd          , Gs          , Hh          , Gs          , Gg          , Gg          , Hh          , Wo          , Ww          , Hh          , Hh          , Gg          , Gd^Vo       , Hh          , Gg          , Hh          , Gd^Vhr      , Re          , Gs          , Gg          , Gg          , Gs          , Gg          , Hh          , Hh          , Gg          , Gg          , Mm          , Hh          , Md          , Md^Xm       , Hhd         , Gs          , Gs          , Hhd         , Gd^Vhr      , Rd          , Rd^Es       , Rd          , Gd          , Gd          , Gd          , Gd          , Gd          
Gd^Edp      , Gd          , Gd^Es       , Gd          , Gd          , Hhd         , Gd          , Rd          , Re          , Hh          , Re          , Hh          , Rb          , Gg          , Gg          , Ww          , Wo          , Gg          , Hh          , Gg          , Gs          , Gs          , Gg          , Gg          , Gs          , Gg          , Gg          , Gs          , Gg          , Gs          , Gs^Es       , Gs          , Re          , Hh          , Gs          , Hh          , Hh          , Mm          , Md^Xm       , Hhd         , Hhd         , Hhd         , Gd          , Gd          , Gd          , Gd          , Gs          , Gd          , Gd          , Gs          , Gd^Es       , Gd          
Gd          , Gd          , Hhd         , Gd          , Hhd         , Gd          , Gd          , Gd          , Gd          , Re          , Gd          , Re          , Gg          , Re          , Rb          , Gg          , Ww          , Hh          , Gg          , Gg          , Gg          , Gg          , Gg          , Gg          , Gg          , Gs          , Gg          , Gs          , Gs          , Gs          , Gg          , Gs          , Re          , Hh          , Gs          , Gs          , Gs          , Mm          , Mm          , Md^Xm       , Md^Xm       , Hhd         , Gd          , Gd          , Gd          , Gd          , Gd          , Gd          , Gd          , Gs          , Gd          , Gd          
Gd          , Gd          , Gd          , Gd          , Md          , Hhd         , Gd          , Gd          , Gd^Es       , Gd          , Gs          , Gs          , Hhd         , Gg          , Co          , Rb          , Wwf         , Gg          , Rb          , Rb          , Rb          , Gg          , Rb          , Gg          , Rb          , Gg          , Gs          , Gg          , Gg          , Gg          , Gg          , Gg          , Hh          , Gd^Vhr      , Gs          , Gg          , Gs          , Hh          , Gg          , Gs          , Mm          , Hh          , Hhd         , Gd          , Gs          , Gs          , Gs          , Gd          , Gd^Es       , Gd          , Gd          , Gd          
Gd          , Gd          , Hhd         , Gd          , Gd          , Gd          , Gd          , Gd          , Hhd         , Gd          , Gd          , Gd          , Gs          , Co          , 3 Ko        , Co          , Wo          , Rb          , Gg          , Gg          , Gg          , Rb          , Gs^Es       , Rb          , Gg          , Rb          , Rb          , Rb          , Rb          , Rb          , Rb          , Gg          , Hh          , Hh          , Gs          , Gg          , Gs          , Hh          , Gs^Es       , Gs          , Md          , Mm^Xm       , Gs          , Hhd         , Gs          , Gs          , Gs          , Gd          , Gd          , Gd          , Gs          , Gd          
Gd          , Gd          , Gd          , Gd          , Hhd         , Gd^Es       , Hhd         , Gd          , Hhd         , Hhd         , Gd          , Gd^Vo       , Gd          , Md          , Md          , Hh          , Gs          , Ww          , Ww          , Gg          , Gs          , Gg          , Sm          , Ss          , Ww          , Gg          , Ww          , Gg          , Gg          , Gg          , Gg          , Rb          , Rb          , Gg          , Gg          , Hh          , Gs          , Gs          , Hh          , Gg          , Md          , Mm^Xm       , Hhd         , Gs          , Gs          , Gs          , Gd          , Gd          , Gs          , Gd          , Gs          , Gs          
Gd          , Hhd         , Gd          , Hhd         , Gd          , Hhd         , Gd          , Gd          , Gd          , Gd          , Gd          , Hhd         , Gs          , Md          , Md^Xm       , Hh          , Hh          , Gg          , Wo          , Gg          , Ww          , Gg          , Ww          , Ww          , Wo          , Ww          , Ww          , Ww          , Ww          , Ss          , Gg^Efm      , Gg          , Gg          , Rb          , Rb          , Gg          , Gs          , Gg          , Gs          , Mm          , Md          , Md^Xm       , Mm^Xm       , Hhd         , Gd          , Gs          , Gd          , Gd          , Gs          , Gs          , Gs          , Gd          
Gd^Vo       , Gd^Edpp     , Gd          , Gd          , Gd^Es       , Gd          , Md          , Hhd         , Gd          , Gd^Es       , Gs          , Gd          , Hhd         , Md          , Md^Xm       , Hh          , Hh          , Gg          , Ww          , Ww          , Gg          , Wo          , Ww          , Ww          , Ww          , Ww          , Ww          , Ww          , Wo          , Ww          , Ww          , Gg          , Ss          , Gg          , Gg          , Rb          , Rb          , Gs          , Gs          , Hh          , Hh          , Hhd         , Mm^Xm       , Gd          , Gs          , Gd          , Hhd         , Gd          , Gs          , Rd          , Gs          , Gs          
Md          , Hhd         , Hhd         , Hhd         , Gd          , Gd          , Hhd         , Hhd         , Hhd         , Gd          , Gd          , Hhd         , Hhd         , Md          , Gg          , Md^Xm       , Hh          , Gs^Es       , Gg          , Gg          , Ww          , Wo          , Wo          , Gg          , Ww          , Gg          , Gg          , Ww          , Wo          , Wo          , Ww          , Ww          , Ww          , Ww          , Ww          , Gg          , Ww          , Rb          , Rb          , Gs          , Hh          , Hhd         , Mm^Xm       , Hhd         , Gs          , Gs          , Hhd         , Gs          , Gs          , Gd^Vhr      , 2 Re        , Rd          
Gd          , Md          , Md          , Hhd         , Md          , Gd          , Gd          , Md          , Hhd         , Gd          , Hhd         , Hhd         , Md          , Md          , Md          , Mm^Xm       , Md^Xm       , Hh          , Gd^Vo       , Ss          , Ww          , Ww          , Ww          , Ww          , Hh          , Ww          , Ss          , Ww          , Ww          , Wo          , Ww          , Ww          , Ss          , Ww          , Ww          , Ww          , Ww          , Gg          , Wwf         , Rb          , Rb          , Mm          , Mm^Xm       , Mm^Xm       , Ce          , Ce          , Ke          , Gs          , Re          , 1 Re        , 5 Gs        , Gs          
Gd          , Md          , Gd          , Md          , Hhd         , Md          , Md          , Hhd         , Gd          , Md          , Hhd         , Gd          , Md          , Md          , Md          , Md          , Md^Xm       , Hh          , Hh          , Gg          , Ww          , Wo          , Ww          , Ww          , Ww          , Gs^Vc       , Ww          , Ww          , Wo          , Ww          , Ww          , Ww^Ewl      , Ss          , Gg          , Ss          , Ss          , Gg          , Ww          , Ww          , Ww          , Wo          , Rb          , Rb          , Hh          , Hhd         , Ce          , Re          , Re          , Gs          , Gs          , Gs          , Gs          
Md          , Gd          , Md          , Gd          , Md          , Md          , Md          , Gd          , Hhd         , Gs          , Md          , Md          , Gd          , Gd          , Gs          , Hhd         , Md          , Md^Xm       , Hh          , Gg          , Gg          , Ww          , Ww          , Ww          , Ww          , Ww          , Ww          , Wo          , Ww^Ewl      , Ww          , Ss          , Gg          , Gg^Em       , Ss          , Gs^Vc       , Ss          , Gg^Efm      , Gg          , Gs          , Gg          , Hh          , Wo          , Ww          , Rb          , Rb          , Rb          , Gg          , Gg          , Gg          , Gg          , Gg          , Gs          
Mm          , Md          , Gd          , Md          , Hhd         , Md          , Md          , Hhd         , Md          , Md          , Md          , Md          , Md          , Md          , Hhd         , Md          , Hhd         , Mm^Xm       , Mm^Xm       , Hh          , Hh          , Gs          , Ss          , Ww          , Gg          , Ww          , Gg          , Ww          , Gg          , Sm          , Ss          , Ss          , Gg          , Ss          , Gs          , Gg          , Gg          , Gg          , Hh          , Hh          , Mm^Xm       , Mm^Xm       , Hh          , Wo          , Ww          , Gg          , Ww          , Gg          , Ww          , Ww          , Ww          , Ww          
Hhd         , Md          , Md          , Hhd         , Gd          , Hhd         , Hhd         , Md          , Hhd         , Gd          , Md          , Md          , Md          , Md          , Md          , Md          , Md          , Hhd         , Mm^Xm       , Hh          , Hh          , Gg          , Gs          , Gg          , Ss          , Gg^Efm      , Gg          , Ss          , Ss          , Gg          , Gg          , Gg          , Ss          , Gg          , Gg          , Gg          , Gg          , Hh          , Mm^Xm       , Mm^Xm       , Mm          , Hh          , Hh          , Hh          , Gg          , Ww          , Ww          , Ww          , Ww          , Ww          , Ww          , Ww          
Gd          , Hhd         , Mm          , Md          , Md          , Hhd         , Md          , Hhd         , Md          , Md          , Ms          , Md          , Md          , Md          , Md          , Hhd         , Md          , Md          , Md          , Mm^Xm       , Md^Xm       , Hh          , Hh          , Gg          , Gg          , Ss          , Gg          , Gg          , Gg          , Ss          , Hh          , Gg          , Hh          , Hh          , Hh          , Hh          , Mm^Xm       , Mm          , Mm          , Mm          , Gs          , Gs          , Hh          , Gs          , Gs          , Gg          , Ss          , Ww          , Gg          , Gg          , Gg          , Ww          
Mm          , Gd          , Hhd         , Hhd         , Md          , Hhd         , Gd^Vo       , Md          , Md          , Md          , Md          , Ms          , Md          , Md          , Md          , Md          , Md^Xm       , Hhd         , Md^Xm       , Md^Xm       , Mm          , Mm^Xm       , Mm^Xm       , Hh          , Hh          , Hh          , Hh          , Hh          , Hh          , Hh          , Mm^Xm       , Hh          , Mm^Xm       , Hh          , Mm^Xm       , Mm^Xm       , Md          , Hh          , Gs          , Mm          , Gs          , Hh          , Hh          , Gs          , Gs          , Gs          , Gs          , Ss          , Gg          , Ss          , Ss          , Gg^Efm      
Gd          , Mm          , Mm          , Md          , Md          , Md          , Md          , Mm          , Md          , Md          , Ms          , Md          , Ms          , Md          , Md^Xm       , Md^Xm       , Mm          , Md^Xm       , Md          , Mm          , Md          , Mm          , Md          , Md^Xm       , Md^Xm       , Mm^Xm       , Md^Xm       , Mm^Xm       , Mm^Xm       , Mm          , Md          , Mm^Xm       , Md          , Md          , Md          , Md          , Mm          , Mm          , Hh          , Hh          , Gs          , Gs          , Gs          , Gs          , Gs          , Gs^Es       , Gs          , Gs          , Gs          , Gs          , Ss          , Gg          
Md          , Md          , Mm          , Ms          , Mm          , Md          , Md          , Md          , Md          , Md          , Md          , Md          , Md^Xm       , Md^Xm       , Mm^Xm       , Mm          , Md          , Md          , Hhd         , Md          , Mm          , Md          , Hhd         , Hhd         , Hhd         , Md          , Md          , Md          , Md          , Md          , Hh          , Hh          , Mm          , Md          , Hhd         , Gd          , Hh          , Hh          , Gs          , Gs          , Gs          , Gs          , Gs          , Gs          , Gs          , Gs          , Gs          , Ss          , Ss          , Gs          , Ss          , Gs          
Mm          , Mm          , Ms          , Mm          , Mm          , Mm          , Md          , Md          , Md          , Hhd         , Md^Xm       , Mm^Xm       , Mm          , Md          , Md          , Md          , Md          , Hhd         , Gd          , Hhd         , Gs          , Hhd         , Gs          , Gd          , Hhd         , Hhd         , Gs          , Gs          , Md          , Hh          , Hhd         , Mm          , Hh          , Hh          , Gd          , Gd          , Gs^Vh       , Rb^Gvs      , Gs          , Gs          , Gs          , Gs          , Gd          , Gd          , Gd          , Gs          , Gd          , Gs          , Gs          , Gs          , Gs          , Gd          
Mm^Xm       , Mm          , Mm^Xm       , Mm^Xm       , Mm^Xm       , Mm          , Md          , Md          , Md^Xm       , Mm          , Mm          , Mm          , Mm          , Hhd         , Md          , Md          , Gs          , Gs          , Gd          , Gd          , Gd          , Gd          , Gd          , Gd^Vhr      , Rd          , Gd          , Gd          , Gs          , Hh          , Hh          , Gs          , Gs          , Gs          , Gs          , Gd          , Gd          , Gd          , Gd          , Gd          , Gs          , Gd          , Gs          , Gd          , Gd          , Gd          , Gs          , Gs          , Gd          , Gs          , Gs          , Gs          , Ss          
Mm          , Mm^Xm       , Mm^Xm       , Ms          , Mm          , Mm^Xm       , Mm^Xm       , Md^Xm       , Mm          , Mm          , Mm          , Md          , Md          , Gd^Vo       , Hhd         , Md          , Md          , Hhd         , Hhd         , Gd          , Gd          , Gd^Es       , Gd          , Rd          , Gs          , Gd          , Hhd         , Hhd         , Gs          , Gs          , Gd          , Gs          , Gd          , Gd          , Gd          , Gs          , Gd          , Gd          , Gd          , Gd          , Gs^Es       , Gs          , Gd          , Gd          , Gd          , Gs          , Gs          , Gs          , Gs          , Gs          , Gs          , Gs          
Gs          , Mm          , Mm          , Ww          , Hh          , Mm          , Hhd         , Hhd         , Mm          , Mm          , Md          , Md          , Gs          , Mm          , Md          , Md          , Hhd         , Hhd         , Gd          , Gd          , Gd          , Gd          , Gd          , Gd          , Gd          , Hhd         , Hhd         , Gd          , Gd          , Gd          , Gd          , Gd          , Gd          , Gd          , Gd          , Gs          , Gs^Edp      , Gd          , Gd          , Gd          , Gd          , Gd          , Gd^Es       , Gd          , Gd          , Gs          , Gs          , Gd          , Gs          , Gs          , Gg          , Gs          
Gg          , Hh          , Ww          , Ww          , Gg          , Gs          , Hh          , Hhd         , Md          , Md          , Md          , Md          , Mm          , Mm          , Md          , Hhd         , Gd          , Gs          , Rd          , Gd          , Gd          , Gd          , Gd          , Hhd         , Md          , Hhd         , Gd          , Gd          , Gd          , Gd^Es       , Gd          , Gd          , Gs          , Gs          , Gd^Es       , Gd          , Gs          , Gs          , Gd          , Gs          , Gs          , Gd          , Gd          , Gd          , Gd          , Gs          , Gs          , Gs          , Gg          , Gs          , Gg          , Gg          
Gg          , Ww          , Gg          , Gg          , Gs          , Gs          , Mm          , Mm          , Gg          , Mm          , Md          , Hhd         , Hhd         , Md          , Mm          , Hhd         , Hhd         , Gd^Vhr      , Gd          , Gd^Es       , Gd^Edp      , Gd          , Gd          , Hhd         , Gd          , Hhd         , Gd          , Gs          , Gd          , Gd          , Gd          , Gd          , Gs          , Gd          , Gd          , Gd          , Gs          , Gs          , Gs          , Gs          , Gd          , Gd          , Gd          , Gd          , Gs          , Gs          , Rb^Gvs      , Rb^Gvs      , Rb^Gvs      , Gs^Vh       , Gg          , Gg          
Gg          , Ww          , Gg          , Gs          , Gs          , Hh          , Gs          , Mm          , Mm          , Mm          , Mm          , Gd          , Gd          , Mm          , Mm          , Hhd         , Gd          , Gd          , Gd          , Gd          , Gs          , Gd          , Gd          , Gd          , Gd          , Gd          , Gd          , Gd          , Gd          , Gd          , Gg          , Gd          , Gs          , Gd          , Gd          , Gd^Edpp     , Gs          , Gs          , Gs          , Gd          , Gd          , Gd          , Gd          , Gs          , Gs          , Gg          , Gg          , Rb^Gvs      , Ww          , Ww          , Ww          , Gg          
