border_size=1
usage=map

Mm          , Mm^Xm       , Mm^Xm       , Mm^Xm       , Mm          , Hh          , Hh          , Hh          , Gg          , Re          , Gg          , Mm          , Mm          , Mm          , Mm          , Gg          , Gg          , Mm          , Mm          , Mm          , Mm          , Gg          , Mm^Xm       , Mm^Xm       , Hh^Vhh      , Gg          , Hh          , Gg          , Hh          , Gg          , Gg          , Gg          , Mm          , Mm          , Mm          , Mm          , Gs          , Gg          , Re          , Rb          , Hh          , Gg          , Mm          , Mm          , Mm^Xm       , Mm          
Mm          , Ms^Xm       , Mm          , Mm          , Hh          , Mm          , Hh          , Hh          , Gs          , Re          , Hh          , Mm          , Hh          , Mm          , Hh          , Mm          , Mm          , Mm          , Mm          , Mm          , Gg^Efm      , Mm^Xm       , Ms^Xm       , Wo          , Mm          , Gs^Fds      , Mm          , Mm          , Mm          , Hh          , Hh          , Hh          , Mm          , Mm          , Mm          , Mm          , Re          , Rb          , Hh          , Gs          , Mm          , Mm          , Mm          , Mm          , Mm^Xm       , Ms          
Mm^Xm       , Ms^Xm       , Mm          , Mm          , Hh          , Mm          , Hh          , Gg          , Re          , Re          , Gs          , Hh          , Mm          , Mm          , Mm          , Gg^Es       , Mm          , Mm          , Mm          , Hh          , Mm          , Ms^Xm       , Mm          , Mm          , Mm          , Mm          , Hh          , Mm          , Mm          , Mm          , Gg          , Hh          , Mm          , Mm          , Mm          , Mm          , Re          , Hh          , Hh          , Mm          , Mm          , Mm          , Ms          , Ms          , Mm^Xm       , Ms          
Mm^Xm       , Mm          , Hh          , Mm          , Hh          , Mm          , Mm          , Hh          , Rb          , Gg          , Mm          , Mm          , Mm          , Mm          , Mm^Xm       , Mm          , Ms^Xm       , Mm          , Mm^Xm       , Mm          , Ms^Xm       , Mm^Xm       , Mm          , Mm          , Mm          , Gg          , Hh          , Mm          , Mm          , Mm          , Gg          , Mm          , Mm          , Mm          , Mm          , Mm          , Rb          , Gg          , Mm          , Mm          , Mm          , Mm          , Mm^Xm       , Mm^Xm       , Ms          , Ms          
Mm          , Hh          , Hh^Vhh      , Mm          , Hh          , Hh          , Hh          , Rb          , Mm          , Gg          , Mm          , Mm          , Mm^Xm       , Mm          , Gg          , Ms^Xm       , Mm          , Mm^Xm       , Mm          , Mm^Xm       , Hh          , Mm          , Hh          , Gg^Es       , Hh          , Gg          , Gg          , Hh          , Mm          , Hh          , Mm          , Mm          , Mm          , Mm          , Mm          , Re          , Hh          , Hh          , Mm          , Mm          , Mm          , Mm^Xm       , Ms          , Ms          , Ms          , Ms          
Gg          , Hh          , Gg^Efm      , Gg          , Gg          , Gg          , Gg          , Rb          , Gg          , Mm          , Mm          , Mm          , Mm^Xm       , Hh          , Mm          , Mm          , Mm          , Mm          , Mm          , Mm          , Hh          , Hh          , Hh          , Hh          , Hh          , Hh          , Gs          , Hh          , Hh          , Hh          , Mm          , Mm          , Mm          , Mm          , Re          , Re          , Gs^Vh       , Mm          , Mm          , Mm          , Mm^Xm       , Mm^Xm       , Ms          , Ww          , Hh          , Hh          
Hh          , Hh          , Gg          , Gg          , Mm          , Gg^Efm      , Gg          , Re          , Gs          , Mm          , Gg          , Gs          , Mm^Xm       , Mm          , Mm          , Mm          , Mm          , Hh          , Hh          , Mm          , Hh          , Gg          , Hh          , Gg          , Hh          , Hh          , Hh          , Gs          , Gg          , Hh          , Gs^Vh       , Mm          , Gg          , Rb          , Hh          , Gs          , Mm          , Mm          , Mm          , Mm^Xm       , Mm          , Ms          , Ww          , Ww          , Mm          , Gg          
Mm          , Hh          , Hh          , Mm          , Hh          , Gg          , Gs          , Re          , Gg          , Gg          , Mm^Xm       , Mm^Xm       , Mm          , Hh          , Mm          , Mm          , Mm          , Gg          , Mm          , Hh          , Mm          , Gg          , Hh          , Hh          , Hh          , Hh          , Hh          , Hh          , Hh          , Mm          , Gg          , Mm          , Rb          , Re          , Gs          , Hh          , Mm          , Mm          , Mm          , Mm^Xm       , Hh          , Mm          , Ww          , Hh          , Mm          , Mm          
Gg          , Mm          , Mm^Xm       , Mm          , Mm^Xm       , Mm          , Mm          , Rb          , Mm          , Mm^Xm       , Hh          , Mm          , Mm          , Mm          , Hh          , Gg          , Mm          , Mm          , Hh          , Mm          , Mm          , Mm          , Mm          , Hh          , Gs          , Hh          , Hh          , Gg          , Re          , Gg          , Re          , Rb          , Gg          , Gg          , Gg          , Gg          , Mm          , Mm          , Mm          , Mm^Xm       , Mm^Xm       , Mm          , Mm          , Ww          , Ww          , Gg^Efm      
Mm^Xm       , Mm          , Mm^Xm       , Mm^Xm       , Hh          , Mm          , Gg          , Rb          , Mm          , Mm          , Mm          , Hh          , Hh          , Gg^Efm      , Mm          , Hh          , Hh          , Hh          , Hh          , Mm          , Hh          , Mm          , Hh          , Gg          , Re          , Re          , Re          , Re          , Gg          , Re          , Ce          , Ce          , 2 Ke        , Hh          , Hh          , Hh          , Mm          , Mm          , Mm          , Mm          , Mm^Xm       , Mm          , Mm          , Hh          , Hh          , Wwf         
Mm^Xm       , Mm^Xm       , Mm          , Mm          , Mm          , Mm          , Mm          , Rb          , Mm          , Mm          , Gg          , Hh          , Mm          , Gg          , Mm          , Hh          , Mm          , Hh          , Re          , Hh          , Re          , Re          , Re          , Re          , Hh          , Gg          , Gg          , Gs          , Gg          , Rb          , Mm          , Ce          , Hh          , Gg          , Hh          , Gg          , Mm          , Mm          , Mm          , Mm^Xm       , Hh          , Hh^Fp       , Mm          , Mm          , Gg          , Gg          
Mm          , Mm          , Mm          , Mm          , Mm          , Mm          , Mm          , Re          , Mm          , Hh          , Mm          , Mm          , Gg          , Mm          , Rb          , Hh^Vhh      , Rb          , Re          , Gg          , Re          , Hh          , Gg          , Gs          , Gg          , Gs          , Gs          , Hh          , Hh          , Re          , Rb          , Hh          , Mm          , Mm          , Hh          , Gg          , Hh          , Hh          , Mm          , Mm          , Mm^Xm       , Hh          , Hh^Fp       , Gg^Efm      , Gg^Es       , Mm          , Hh          
Gg          , Hh          , Hh          , Hh          , Mm          , Hh          , Gg          , Re          , Re          , Mm          , Rb          , Gg          , Rb          , Rb          , Mm          , Rb          , Wo          , Hh          , Gg          , Gg          , Gg          , Gg          , Gg          , Gg          , Gs          , Gg          , Hh          , Re          , Gs          , Mm          , Hh          , Gg          , Hh          , Hh          , Mm          , Hh          , Hh          , Mm          , Mm^Xm       , Mm^Xm       , Hh          , Mm          , Mm          , Mm          , Mm          , Gg          
Mm          , Mm          , Gg^Es       , Hh          , Mm          , Mm          , Hh          , Re          , Gg          , Rb          , Mm          , Rb          , 1 Ke        , Ce          , Ce          , Gg          , Gs          , Gs          , Gg          , Gs          , Gg          , Hh          , Gs          , Gs          , Gs          , Gs          , Gs          , Re          , Mm          , Hh^Vhh      , Gg          , Gs          , Hh          , Gg          , Mm          , Gg          , Hh          , Mm          , Mm^Xm       , Mm          , Hh          , Mm          , Hh          , Gg          , Gg^Efm      , Gg^Efm      
Mm          , Mm          , Hh          , Mm          , Gg          , Hh          , Gg          , Rb          , Re          , Mm          , Mm          , Hh          , Gg          , Ce          , Gs          , Gg          , Gs          , Hh          , Hh          , Gg          , Gs          , Hh          , Gs          , Gg          , Gs          , Gs          , Re          , Re          , Mm          , Hh          , Mm          , Gg          , Hh          , Mm          , Mm          , Mm          , Mm          , Mm          , Mm^Xm       , Mm          , Mm          , Gg          , Gg^Em       , Ss          , Ss          , Gg^Efm      
Hh          , Mm          , Mm          , Mm          , Hh          , Hh          , Hh          , Gg          , Re          , Mm          , Mm          , Gg          , Gg          , Gs          , Hh          , Hh          , Gg          , Hh          , Gg          , Gg          , Gg          , Hh          , Hh          , Gg          , Rb          , Re          , Mm          , Mm          , Hh          , Hh          , Gg          , Gg          , Mm          , Gg          , Mm          , Mm          , Mm          , Mm          , Mm^Xm       , Mm          , Mm          , Gg          , Gg^Efm      , Ss          , Ss          , Ss          
Hh          , Mm          , Mm          , Mm          , Gg          , Hh          , Hh          , Gs          , Gs          , Re          , Re          , Mm          , Gg          , Gs          , Gs          , Gg          , Hh          , Gs          , Gg          , Hh          , Gs          , Gs          , Gs          , Gg          , Re          , Hh          , Gs          , Hh          , Hh          , Hh          , Hh          , Gg          , Mm          , Gg          , Mm          , Gg^Efm      , Mm          , Mm^Xm       , Mm          , Mm          , Mm          , Ss          , Ss          , Sm          , Wwf         , Ww          
Gg          , Hh          , Mm          , Mm          , Mm          , Gg          , Hh          , Gs          , Hh          , Gg          , Hh          , Re          , Rb          , Hh          , Mm          , Hh          , Gg          , Hh          , Hh          , Gg          , Gs          , Gg          , Hh          , Rb          , Hh          , Gg          , Hh          , Gg          , Hh          , Mm          , Hh          , Gg          , Mm          , Mm          , Mm          , Mm          , Ms          , Ms^Xm       , Mm^Xm       , Mm          , Mm          , Gg          , Ss          , Ww          , Ss          , Gg          
Gg^Efm      , Hh          , Mm          , Hh          , Gg          , Mm          , Mm          , Gs          , Gg          , Hh          , Hh          , Gg          , Gg          , Rb          , Rb          , Gg          , Gg          , Gg^Efm      , Hh          , Gg          , Gs          , Gg          , Rb          , Rb          , Hh          , Gg^Es       , Hh          , Mm          , Gg          , Gg          , Hh          , Mm          , Mm          , Mm          , Mm          , Mm          , Mm^Xm       , Ms^Xm       , Mm          , Mm          , Mm          , Ss          , Ss          , Ww          , Wo          , Ww          
Ww          , Gg^Efm      , Hh          , Mm          , Mm          , Mm          , Gg          , Hh          , Mm          , Gg          , Hh          , Gg          , Hh          , Hh          , Gg          , Re          , Re          , Gg          , Gg          , Hh          , Gs^Vh       , Gg          , Rb          , Hh          , Gg          , Gg          , Mm          , Gg          , Mm          , Mm          , Mm          , Mm          , Mm^Xm       , Mm^Xm       , Wo          , Mm          , Mm^Xm       , Mm          , Ww          , Mm          , Mm          , Mm          , Ww          , Ww          , Wo          , Ww          
Gg          , Wo          , Ww          , Wo          , Wo          , Mm          , Mm          , Mm          , Mm          , Mm          , Gg          , Hh          , Gg          , Gg^Es       , Hh          , Hh          , Gs          , Rb          , Re          , Hh          , Hh          , Rb          , Gg          , Gg          , Mm          , Gg          , Mm          , Mm          , Mm          , Mm          , Ms^Xm       , Ms^Xm       , Mm          , Ww          , Ww          , Wo          , Wo          , Wo          , Wo          , Wo          , Wo          , Wo          , Ww          , Wo          , Ww          , Ss          
Mm          , Mm          , Mm          , Gg^Efm      , Ms          , Ww          , Ww          , Mm          , Mm          , Mm          , Mm          , Mm          , Mm          , Mm          , Mm          , Gg          , Mm          , Gg          , Gs          , Re          , Rb          , Rb          , Hh          , Hh          , Hh          , Mm          , Mm^Xm       , Mm^Xm       , Ms^Xm       , Ms^Xm       , Ms          , Mm          , Gg^Efm      , Wo          , Mm          , Ww          , Ww          , Wo          , Wo          , Wo          , Ww          , Ww          , Gg          , Gg          , Ss^Vhs      , Sm          
Mm          , Mm          , Mm          , Mm          , Mm          , Ms          , Ms          , Ms          , Hh          , Mm          , Mm          , Mm          , Mm          , Mm          , Mm          , Mm          , Mm          , Mm          , Mm          , Gg          , Re          , Gg          , Hh          , Hh          , Hh          , Mm          , Mm^Xm       , Mm          , Mm          , Ms          , Ww          , Gg          , Ww          , Ww          , Wo          , Wo          , Wo          , Wo          , Ww          , Ww          , Ww          , Ss          , Gg          , Ss          , Ss          , Ss          
Mm          , Mm          , Mm          , Mm          , Hh          , Ms          , Ms^Xm       , Hh          , Mm^Xm       , Mm^Xm       , Mm^Xm       , Mm^Xm       , Mm^Xm       , Hh          , Mm^Xm       , Mm^Xm       , Mm^Xm       , Mm^Xm       , Mm          , Hh          , Re          , Gs          , Mm          , Mm          , Mm          , Mm          , Wo          , Ww          , Ww          , Ww          , Wo          , Ww          , Wo          , Wo          , Ww          , Wo          , Wo          , Ww          , Gs^Vc       , Ww          , Gg          , Gg          , Ss          , Gg^Efm      , Ss          , Gg          
Mm^Xm       , Mm          , Mm          , Hh          , Mm^Xm       , Ms^Xm       , Wo          , Mm^Xm       , Mm          , Mm          , Mm          , Mm          , Mm          , Mm^Xm       , Mm          , Mm          , Mm          , Mm          , Hh          , Hh          , Rb          , Gg          , Mm          , Mm          , Mm          , Mm          , Wo          , Ww          , Wo          , Wo          , Wo          , Wo          , Wo          , Wo          , Wo          , Wo          , Ww          , Ww          , Gg          , Ss          , Gg          , Gg          , Gg          , Gg          , Gg          , Gg          
Mm          , Mm^Xm       , Mm^Xm       , Mm^Xm       , Mm          , Mm          , Mm          , Mm          , Mm          , Mm          , Mm          , Mm          , Mm          , Mm          , Mm          , Mm          , Mm          , Mm          , Mm          , Gg          , Re          , Gs          , Mm          , Mm          , Mm          , Wo          , Wo          , Ww          , Wo          , Wo          , Wo          , Wo          , Ww          , Wo          , Wo          , Ww          , Ww          , Wo          , Gg^Efm      , Ss          , Gg          , Gg          , Gg          , Gg          , Rrc         , Rrc         
Mm          , Mm          , Mm          , Mm          , Mm          , Mm          , Hh          , Mm          , Mm          , Mm          , Mm          , Gg          , Hh          , Hh^Fp       , Wo          , Mm          , Mm          , Mm          , Mm          , Gg          , Rb          , Gg          , Gg          , Mm          , Mm          , Mm          , Ww          , Wo          , Wo          , Wo          , Ww          , Wo          , Ww          , Wo          , Ww          , Ss          , Gg          , Gg          , Gg          , Gg          , Gg          , Gg          , Rrc         , Rrc         , Rrc         , Rrc         
Hh          , Mm          , Hh          , Hh          , Mm          , Hh          , Mm          , Hh          , Hh          , Mm          , Hh          , Mm          , Mm          , Mm^Xm       , Mm^Xm       , Mm^Xm       , Mm          , Mm          , Mm          , Hh^Vhh      , Re          , Gg          , Mm          , Mm          , Mm          , Mm          , Ww          , Wo          , Wo          , Ww          , Ww          , Ww          , Gg          , Ww          , Gg          , Gg          , Gg          , Gg          , Gs          , Gg          , Rrc         , Rrc         , Rrc         , Rrc         , Gg          , Gg          
Hh          , Mm          , Mm          , Hh          , Mm          , Mm          , Gg          , Hh          , Mm          , Hh          , Gg          , Mm          , Mm^Xm       , Mm^Xm       , Mm          , Hh          , Mm          , Mm          , Rb          , Rb          , Mm          , Mm          , Mm          , Mm          , Mm          , Mm          , Wo          , Wo          , Ww          , Ww          , Gg^Efm      , Gg          , Gg          , Gs^Vh       , Gg          , Gg          , Gg          , Gg          , Rrc         , Rrc         , Rrc         , Rrc         , Gg          , Gg          , Gs          , Gg          
Hh          , Mm          , Mm          , Mm          , Hh^Fp       , Mm          , Mm          , Hh          , Mm          , Mm          , Hh          , Mm          , Mm          , Mm          , Hh          , Hh          , Mm          , Gg          , Re          , Mm          , Mm          , Mm          , Mm          , Mm          , Ww          , Ww          , Wo          , Ww          , Wo          , Ww          , Gg          , Gg          , Gg          , Gg          , Ch          , Ch          , Rrc         , Rrc         , Rrc         , Rrc         , Hh          , Gg          , Gg          , Gg          , Gg          , Gs^Vh       
Mm          , Hh^Fp       , Hh^Fp       , Hh^Fp       , Mm          , Gg^Efm      , Hh          , Mm          , Mm^Xm       , Mm^Xm       , Mm          , Mm          , Gg          , Mm          , Hh          , Mm          , Hh          , Hh          , Re          , Mm          , Mm          , Mm          , Gg          , Hh          , Ww          , Wo          , Ww          , Wo          , Ww          , Ww          , Gg          , Gg          , Gg          , Gs          , Rrc         , Rrc         , Rrc         , Rrc         , Ch          , Gg          , Gg          , Gg          , Hh          , Gg          , Gs          , Gg          
Gg          , Gg          , Hh          , Hh^Fp       , Gg          , Mm          , Mm          , Mm          , Mm          , Mm          , Hh^Fp       , Hh          , Mm          , Mm          , Hh          , Mm          , Gg^Es       , Mm          , Gg          , Rb          , Rb          , Hh          , Ww          , Ww          , Ww          , Ww          , Ww          , Ww          , Gg          , Gg          , Gg          , Gg          , Rrc         , Rrc         , Rrc         , Rrc         , Ch          , Rrc         , Rrc         , Gg          , Gg          , Hh          , Gg          , Gg          , Gg          , Gg          
Mm          , Hh          , Hh^Fp       , Hh          , Hh          , Mm          , Gg^Efm      , Mm          , Hh          , Hh          , Mm          , Hh          , Mm          , Mm          , Hh          , Hh          , Mm          , Mm          , Hh          , Gg          , Gg          , Rb          , Wo^Bw\      , Ww          , Gg          , Ww          , Gg          , Gg          , Gg          , Gg          , Rrc         , Rrc         , Rrc         , Rrc         , Hh          , Ch          , Kh          , Ch          , Gg          , Rrc         , Rr          , Gg          , Hh          , Gg          , Gs          , Gg          
Hh          , Hh^Fp       , Mm          , Mm          , Hh^Fp       , Mm          , Mm          , Mm          , Hh          , Gg          , Mm          , Hh          , Hh          , Mm          , Mm          , Mm          , Mm          , Mm          , Hh          , Hh          , Wo          , Wo          , Gg          , Rb          , Rb          , Gg          , Gg          , Gg          , Rrc         , Rrc         , Rrc         , Rrc         , Gg          , Hh          , Hh          , Gg          , Hh          , Hh          , Hh^Vhh      , Gs          , Hh          , Rr          , Rrc         , Gs^Vh       , Gs          , Gg          
Hh^Fp       , Mm          , Mm          , Hh          , Mm          , Mm          , Mm          , Mm          , Mm          , Hh          , Mm          , Hh          , Gg          , Mm          , Mm          , Mm          , Wo          , Gg          , Ww          , Ww          , Ww          , Wo          , Gg          , Gg          , Gg          , Rb          , Rrc         , Rrc         , Rrc         , Rrc         , Gs          , Gg          , Hh          , Hh          , Mm          , Hh          , Mm          , Mm          , Mm          , Hh          , Gs          , Hh          , Gs          , Rr          , Rr          , Gg          
Hh          , Hh^Fp       , Hh          , Mm          , Gg          , Mm          , Hh          , Gg          , Mm          , Hh          , Hh          , Hh^Fp       , Wo          , Gg          , Ww          , Wo          , Ww          , Ww          , Ww          , Ww          , Gg          , Gg          , Gg          , Gg          , Rrc         , Rrc         , Rrc         , Rrc         , Gs          , Gg          , Gg          , Gg          , Gg          , Gg          , Hh          , Hh          , Mm          , Hh          , Mm          , Hh          , Gg          , Gg          , Hh          , Gs          , Gs          , Rr          
Hh^Fp       , Mm          , Gg          , Mm          , Mm          , Mm          , Mm          , Mm          , Gg          , Gg          , Gg          , Wo          , Ww          , Ww          , Ww          , Ww          , Gg          , Ww          , Ss          , Ss          , Gg          , Gg          , Gg          , Gg          , Rrc         , Rrc         , Rrc         , Gs^Vh       , Gs          , Gg          , Gg          , Hh          , Gg          , Hh          , Gg          , Mm          , Hh          , Hh          , Hh          , Mm          , Mm          , Hh          , Gg          , Gs          , Gs          , Gs          
