border_size=1
usage=map

Gd^Fdw      , Hhd         , Gd          , Gd          , Rd          , Rd          , Rd          , Gd          , Hhd         , Gd^Vo       , Gd          , Gd          , Gd^Es       , Gd          , Rd          , Hhd         , Md^Xm       , Md^Xm       , Md^Xm       , Gd^Fdw      , Rd          , Rd          , Rd          , Rd          , Gd          , Md          , Gd^Fdw      , Md^Xm       , Gd^Fdw      , Rd          , Gd          , Gd          , Gd          , Gd          , Hhd         , Hhd         
Rd          , Gd^Es       , Gd          , Gd          , Rd          , Rd          , Gd          , Gd^Fdw      , Gd^Fdw      , Gd^Fdw      , Hhd         , Gd          , Gd          , Rd          , Rd          , Gd          , Gd          , Gd^Fdw      , Gd          , Rd          , Gd          , Gd          , Gd          , Gd          , Gd          , Gd          , Gd          , Hhd         , Rd          , Rd          , Hhd         , Hhd         , Hhd         , Gd          , Hhd         , Hhd         
Rd          , Rd          , Rd          , Rd          , Gd^Fdw      , Gd^Vo       , Gd          , Gd          , Gd          , Mm          , Gd          , Gd^Fdw      , Gd          , Rd          , Co          , Rd          , Co          , Gd          , Rd          , Rd          , Gd^Fdw      , Gd^Vo       , Gd          , Gd          , Gd          , Gd^Vo       , Rd          , Rd          , Gd          , Gd          , Gd          , Gd          , Gd          , Hhd         , Hhd         , Hhd         
Md          , Gd^Fdw      , Rd          , Rd          , Gd^Efm      , Hhd         , Gd          , Gd          , Gd          , Gd          , Gd          , Gd          , Gd          , Co          , 1 Ko        , Ko          , Rd          , Rd          , Rd          , Md          , Gd          , Gd^Es       , Gd          , Gd^Dr       , Gd^Fdw      , Gd^Fdw      , Gd^Fdw      , Rd          , Hhd         , Gd^Fdw      , Hhd         , Gd          , Hhd         , Hhd         , Mm          , Mm          
Hhd         , Hhd         , Rd          , Gd^Fdw      , Gd^Fdw      , Gd          , Hhd         , Gd^Fdw      , Gd          , Gd^Es       , Gd          , Gd          , Hhd         , Co          , Rd          , Co          , Rd          , Rd          , Gd          , Gd          , Gd          , Gd          , Gd          , Gd^Fdw      , Md^Xm       , Hhd         , Md          , Rd          , Md          , Md          , Md          , Md          , Mm          , Hhd         , Mm          , Mm          
Hhd         , Rd          , Gd          , Gd^Fdw      , Gd^Fdw      , Gd          , Hhd         , Md          , Gd^Fdw      , Gd^Fdw      , Gd          , Gd^Vo       , Gd          , Rd          , Rd          , Rd          , Gd^Fdw      , Hhd         , Gd^Fdw      , Gd          , Gd^Fetd     , Gd^Vo       , Hhd         , Md^Xm       , Md          , Md^Xm       , Md          , Rd          , Hhd         , Md          , Mm          , Mm          , Mm          , Mm          , Mm          , Mm          
Rd          , Rd          , Gd          , Gd          , Gd          , Gd          , Gd          , Gd          , Gd^Fdw      , Gd          , Gd          , Gd          , Rd          , Rd          , Gd          , Md          , Gd          , Gd^Fdw      , Gd          , Gd^Fdw      , Gd          , Hhd         , Hhd         , Md^Xm       , Hhd         , Md          , Md          , Md          , Mm          , Hh          , Hh          , Mm          , Hh          , Mm          , Hh          , Gs          
Gd          , Gd          , Md          , Hhd         , Hhd         , Gd^Fdw      , Hhd         , Gd^Fdw      , Gd          , Mm          , Rd          , Rd          , Rd          , Gd          , Gd          , Mm          , Gd^Fdw      , Gd          , Hhd         , Gd          , Hhd         , Gd          , Hhd         , Hhd         , Md          , Md          , Mm          , Mm          , Mm          , Mm          , Hh          , Re          , Re          , Mm          , Gs          , Hh          
Gd          , Gd^Fdw      , Md          , Gd^Fdw      , Hhd         , Gd          , Gd          , Gd          , Gd          , Gd          , Rd          , Gd          , Gd          , Rd          , Rd          , Gd          , Gd          , Gd          , Hhd         , Hhd         , Mm          , Hhd         , Hh          , Md          , Mm          , Mm          , Mm          , Mm          , Mm          , Mm          , Hh          , Gs          , Gs          , Re          , Rb          , Gs          
Hhd         , Hhd         , Gd^Fdw      , Hhd         , Gd          , Gd          , Gd^Fdw      , Gd          , Rd          , Rd          , Gd          , Gd          , Gd^Vo       , Gd          , Rd          , Gd          , Hhd         , Gd^Fdw      , Hhd         , Hhd         , Md          , Md          , Mm          , Mm          , Gs          , Hh          , Mm          , Mm          , Hh^Fp       , Hh          , Gs          , Gs          , Rb          , Rb          , Gg          , Rb          
Gd^Fdw      , Hhd         , Gd^Vo       , Gd^Fdw      , Gd          , Gd          , Rd          , Rd          , Gd          , Gd          , Gd          , Gd^Fdw      , Gd          , Hhd         , Gd          , Rd          , Hhd         , Gd          , Mm          , Md          , Mm          , Mm          , Mm          , Mm          , Mm          , Mm          , Hh          , Gg          , Hh          , Hh          , Re          , Rb          , Ss          , Ss          , Ss          , Ss          
Gd          , Hhd         , Hhd         , Gd          , Rd          , Rd          , Hhd         , Hhd         , Hhd         , Gd^Fdw      , Gd          , Hhd         , Gd          , Hhd         , Md          , Rd          , Md          , Md          , Mm          , Mm          , Mm          , Mm          , Mm          , Mm          , Mm          , Hh          , Hh          , Gg          , Gs          , Gs          , Rb          , Ss          , Ss          , Ss          , Ss          , Ss          
Gd          , Gd          , Rd          , Rd          , Gd          , Gd          , Hhd         , Md          , Md          , Hhd         , Hhd         , Hhd         , Md          , Md          , Mm          , Hhd         , Mm          , Md          , Mm          , Hh          , Mm          , Hh          , Hh          , Mm          , Mm          , Hh          , Gs          , Hh          , Gs          , Gg          , Sm          , Ss          , Ss          , Gg          , Ss          , Gg          
Rd          , Rd          , Gd          , Hhd         , Gd          , Hhd         , Hhd         , Md          , Hhd         , Hhd         , Mm          , Mm          , Hhd         , Mm          , Hh          , Hh          , Mm          , Hh^Vhh      , Mm          , Mm          , Hh          , Gs          , Gs          , Hh          , Gs          , Hh          , Gs          , Gs          , Ss          , Ss          , Ss          , Ss          , Gg          , Ss          , Gg          , Ww          
Gd          , Gd^Fdw      , Hhd         , Md          , Md          , Gd^Dr       , Md          , Md          , Hhd         , Gd          , Mm          , Mm          , Mm          , Mm          , Mm          , Hh          , Re          , Hh          , Hh          , Hh          , Gs          , Gs          , Gg          , Gs          , Ss          , Gs          , Gg          , Gg          , Ss          , Gg          , Rb          , Gg          , Gg          , Ss          , Ww          , Wo          
Gd          , Gd          , Md          , Hhd         , Mm          , Md          , Md          , Md          , Hh          , Mm          , Gs          , Mm          , Mm          , Mm          , Mm          , Hh          , Re          , Hh          , Gs          , Gs          , Gg          , Gg          , Gg          , Gg          , Ss          , Ss          , Ss          , Ss          , Ss          , Gg          , Rb          , Ss          , Ss          , Ww          , Wo          , Wo          
Hhd         , Hhd         , Md          , Mm          , Gs          , Hhd         , Mm          , Mm          , Mm          , Mm          , Hh          , Mm          , Gg          , Hhd^Vhhr    , Hh          , Hh          , Re          , Hh          , Gs          , Gg          , Gg          , Ss          , Ss          , Gs          , Ss          , Gg          , Ss          , Gg          , Ss          , Ss          , Gg          , Ss^Vhs      , Ww^Bw\      , Ww          , Wo          , Ww          
Hhd         , Md          , Hh          , Mm          , Mm          , Mm          , Mm          , Mm          , Hh^Fp       , Hh          , Hh          , Gs          , Gs          , Gs          , Re          , Re          , Gg          , Gs          , Gg          , Gs          , Gg          , Gg          , Ss          , Ss          , Ss          , Ss          , Gg          , Gg          , Ss          , Ss          , Ss          , Ss          , Ww          , Wo          , Ww          , Ss          
Mm          , Mm          , Mm          , Mm          , Mm          , Mm          , Hh          , Mm          , Hh          , Hh          , Gs          , Gs          , Re          , Re          , Gg          , Gg          , Gg          , Gg          , Gg          , Gg          , Gg          , Ss          , Ss          , Ss          , Gg          , Ss          , Ss          , Ss          , Ss          , Gg          , Ss          , Gg          , Wo          , Wo          , Ww          , Ww          
Hhd         , Mm          , Mm          , Mm          , Mm          , Mm          , Hh          , Gs          , Hh          , Gs          , Re          , Rb          , Gg          , Gs          , Gg          , Gg          , Ss          , Gg          , Ss          , Ss          , Ss          , Sm          , Ss          , Gg          , Gg          , Ss          , Gg          , Ss          , Ss          , Ss          , Ss          , Gg          , Wo          , Ss          , Ww          , Ww          
Hhd         , Hh          , Mm          , Hh^Vhh      , Gs          , Gs          , Gg          , Gg          , Hh          , Re          , Gs          , Gg          , Gg          , Gg          , Gg          , Ss          , Ss          , Ss          , Ss^Vhs      , Gg          , Ss          , Gg          , Ss          , Ss          , Ss          , Ss          , Gg          , Ss          , Gg          , Ww          , Wo          , Wo          , Ss          , Ss          , Ww          , Ss          
Mm          , Hh          , Hh          , Hh          , Gs          , Gs          , Gs          , Gs          , Re          , Re          , Gg          , Gg          , Ss          , Ss          , Ss          , Ww          , Ss          , Ww          , Ss          , Ss          , Gg          , Ss          , Ss          , Gg          , Ss          , Gg          , Ss          , Gg          , Gg          , Ss          , Wo          , Ss          , Ss          , Ww          , Ww          , Ww          
Hh          , Gs          , Gs          , Gs          , Gg          , Gg          , Rb          , Rb          , Gg          , Gg          , Gg          , Gg          , Ss          , Ss          , Ss          , Ww          , Ss          , Ww          , Wwf         , Ss          , Gg          , Gg          , Ss          , Ss          , Ss          , Gg          , Ss          , Ss          , Ss          , Ss          , Wo          , Wwf         , Ww          , Wo          , Gg          , Ss          
Gs          , Gs          , Gs          , Gs          , Rb          , Rb          , Gg          , Ss          , Gg          , Ss          , Ss          , Ss          , Gg          , Ww          , Ss          , Gg          , Ss          , Wo          , Ss          , Ss          , Ss          , Ss          , Ss          , Gg          , Ss          , Ss          , Ss          , Gg          , Ss          , Ss          , Ss          , Wo          , Ww          , Ss          , Ww          , Ss          
Gg          , Gg          , Rb          , Rb          , Gg          , Ss          , Gg          , Gg          , Gg          , Ss          , Gg          , Ss          , Ss          , Ss          , Ss          , Ss          , Gg          , Ww          , Ww          , Wo          , Ss          , Gg          , Ss          , Ss          , Ss          , Ww          , Wo          , Wo          , Wo          , Wo          , Wo          , Wo          , Gg          , Ww          , Ww          , Ww          
Rb          , Rb          , Gg          , Ss          , Gg          , Ss          , Ss          , Ss          , Ss          , Ss          , Ss          , Gg          , Ss          , Wwf         , Ss          , Ss          , Ss          , Gg          , Ss          , Ww          , Ss          , Ss          , Ss          , Wwf         , Ss          , Ss          , Sm          , Ss          , Ss^Vhs      , Ss^Bw/r     , Ss          , Ss          , Wwf         , Ss          , Wo          , Wo          
Gg          , Gg          , Ss          , Ss          , Ss          , Ss          , Ss          , Ss          , Ss          , Ss^Vhs      , Ss          , Ss          , Ss          , Gg          , Gg          , Gg          , Ww          , Ss          , Ss          , Ww          , Ss          , Ww          , Ww          , Ss          , Ss          , Ss          , Ss          , Ss          , Ss          , Gg          , Ss          , Ss          , Ss          , Ss          , Wo          , Ss          
Ss          , Ss          , Ss          , Ss          , Ss          , Gg          , Ss          , Gg          , Gg          , Ww          , Gg          , Ss          , Gg          , Ss          , Ww          , Ss          , Ww          , Ww          , Ss          , Ss          , Wo          , Ww          , Ss^Vhs      , Gg          , Gg          , Ss          , Ss          , Gg          , Sm          , Ss          , Gg          , Ss          , Ss          , Wo          , Ww          , Ww          
Gg          , Gg          , Ss          , Ss          , Ss          , Ss          , Gg          , Ss          , Ss          , Ww          , Ss          , Gg          , Ss          , Ww          , Ss          , Ss          , Ss          , Ss          , Ss          , Ss          , Wo          , Ss          , Gg          , Ww          , Ss          , Ss          , Ss          , Ss          , Ss          , Ss          , Ss          , Wwf         , Wo          , Wo          , Gg          , Ss          
Wo          , Ss          , Wo          , Ss          , Ss          , Ss          , Gg          , Ss          , Gg          , Gg          , Ww          , Ss          , Ss          , Ss          , Ss          , Ss          , Rb          , Ss          , Ss          , Wo          , Ss          , Ss          , Sm          , Ss          , Gg          , Ss          , Ss          , Ss          , Wwf         , Ww          , Ww          , Ww          , Wo          , Hh          , Gg          , Ss          
Ss          , Wo          , Ss          , Wo          , Wo          , Ww          , Wo          , Ss^Vhs      , Gg          , Ss          , Gg          , Ss          , Rb          , Ss          , Wo          , Ss          , Ww          , Rb          , Ww          , Ww          , Ss^Vhs      , Ss          , Rb          , Ww          , Ww          , Ss          , Wwf         , Ss          , Wo          , Ww          , Wo          , Wo          , Ss          , Gg          , Ss          , Gg          
Ss          , Ss          , Ss          , Ww          , Ss          , Wo          , Ss          , Wo          , Wwf         , Ss          , Ss          , Rb          , Ss          , Ss          , Ww          , Ww          , Ss          , Wwf         , Ss          , Ww          , Ww          , Wwf         , Ww          , Ss          , Ww          , Ww          , Ss          , Ww          , Wo          , Wo          , Ww          , Ss          , Wwf         , Ss          , Ss^Vhs      , Ss          
Ss          , Ss          , Ss          , Ww          , Ss          , Gg^Efm      , Rb          , Ss          , Ss          , Wwf         , Ww          , Ss          , Wwf         , Ss^Vhs      , Wo          , Ww          , Ss          , Ss          , Gg          , Ss          , Wwf         , Ss          , Gg^Efm      , Wo          , Ww          , Ss          , Ss^Vhs      , Ww^Bw/r     , Ww          , Wo          , Wo          , Ww          , Ss          , Ww          , Ss          , Ss          
Ss          , Ww          , Gg          , Ww          , Ss          , Ss          , Ss          , Ss          , Wo          , Wo          , Ww          , Ww          , Ss          , Ww          , Ww          , Ss          , Ss          , Sm          , Wo          , Ss          , Gg^Em       , Ss          , Gg          , Wo          , Wo          , Gg          , Gg          , Gg          , Ss          , Ww          , Ww          , Ss          , Ss          , Sm          , Gg          , Ss          
Gg          , Gg          , Rb          , Rb          , Ss          , Ss          , Ww          , Wwf         , Ss          , Ss          , Sm          , Ss^Vhs      , Ss          , Ww          , Ss          , Ww          , Ss          , Ww          , Ss          , Ss          , Ss          , Ss          , Ss          , Ww          , Ww          , Ss          , Ss          , Ss          , Ss          , Ww          , Ww          , Gg          , Ss          , Ss          , Hh          , Ss          
Re          , Md          , Mm          , Ss          , Ss          , Ss          , Ww          , Gg          , Ss          , Ss          , Ss          , Gg          , Ss          , Ss          , Ss          , Ww          , Wwf         , Ss          , Ss          , Ss          , Gg^Efm      , Ss          , Sm          , Ww          , Ss          , Ww          , Wwf         , Ss          , Ww          , Ww          , Wo          , Ss          , Ss          , Hh          , Mm          , Hh          
Mm^Xm       , Mm          , Mm          , Hh          , Ss          , Wo          , Hh          , Ss          , Ss          , Gg          , Hh          , Ss          , Ss          , Ww          , Ss          , Ss          , Ss          , Ww          , Ss          , Ss          , Ss          , Ss          , Ww          , Wwf         , Ss          , Gg          , Ss          , Ww          , Ss          , Ss          , Hh          , Ww          , Ss          , Hh          , Mm          , Ms          
Hh          , Mm^Xm       , Mm^Xm       , Hh          , Hh          , Ww          , Wo          , Ss          , Hh          , Ss          , Mm          , Hh          , Ss          , Ss          , Hh          , Ss          , Ss          , Ww          , Ww          , Mm          , Hh          , Ss          , Ww          , Ss          , Chs         , Chs         , Ss          , Hh          , Ss          , Ss          , Ss          , Ww          , Wo          , Mm^Xm       , Mm^Xm       , Mm          
Mm^Xm       , Mm^Xm       , Ms^Xm       , Mm^Xm       , Mm^Xm       , Mm          , Wo          , Wo          , Mm^Xm       , Hh          , Mm          , Hh          , Chs         , Chs         , Hh          , Ss          , Mm          , Mm          , Ms          , Ms          , Ww          , Ww          , Hh          , Chs         , 2 Khs       , Chs         , Md          , Hh          , Hh          , Ss          , Hh          , Ss          , Mm^Xm       , Ww          , Ww          , Ms          
Mm^Xm       , Ms^Xm       , Ms^Xm       , Ms^Xm       , Mm^Xm       , Mm^Xm       , Ww          , Mm          , Mm^Xm       , Mm          , Gg^Efm      , Mm          , 3 Khs       , Chs         , Mm          , Mm          , Ms          , Ms          , Ms          , Ms          , Ms^Xm       , Hh          , Md          , Ss          , Mm          , Md          , Mm^Xm       , Gg          , Mm^Xm       , Mm          , Mm^Xm       , Mm^Xm       , Mm          , Hh          , Hh          , Ww          
Md          , Mm^Xm       , Mm^Xm       , Mm^Xm       , Mm^Xm       , Ww          , Mm^Xm       , Mm^Xm       , Mm^Xm       , Gg          , Mm^Xm       , Mm          , Mm          , Mm          , Hh          , Ms          , Ms          , Ms          , Ms^Xm       , Ms^Xm       , Ms          , Md          , Md          , Gg^Fet      , Md          , Md          , Mm^Xm       , Mm^Xm       , Ms^Xm       , Mm^Xm       , Mm^Xm       , Hh          , Mm^Xm       , Mm          , Ms^Xm       , Mm^Xm       
Md          , Md          , Ms^Xm       , Wo          , Ms          , Ms^Xm       , Ms^Xm       , Ms^Xm       , Ms^Xm       , Ms^Xm       , Ms^Xm       , Mm^Xm       , Mm^Xm       , Hh          , Mm^Xm       , Hh          , Mm^Xm       , Mm^Xm       , Mm^Xm       , Mm^Xm       , Ms^Xm       , Ms^Xm       , Mm^Xm       , Hh          , Mm^Xm       , Mm^Xm       , Md          , Mm^Xm       , Mm^Xm       , Ms^Xm       , Ms^Xm       , Hh          , Ms^Xm       , Ms^Xm       , Ms^Xm       , Ms^Xm       
Mm^Xm       , Mm^Xm       , Ms^Xm       , Ms^Xm       , Mm^Xm       , Mm^Xm       , Md          , Ms^Xm       , Md          , Ms          , Md          , Ms^Xm       , Ms^Xm       , Ms^Xm       , Ms^Xm       , Ms^Xm       , Ms^Xm       , Ms^Xm       , Ms^Xm       , Ms^Xm       , Mm^Xm       , Ms^Xm       , Mm^Xm       , Mm^Xm       , Md          , Re          , Mm          , Md          , Md          , Mm^Xm       , Md          , Mm^Xm       , Mm^Xm       , Mm^Xm       , Mm^Xm       , Ms          
Mm^Xm       , Mm^Xm       , Mm^Xm       , Mm^Xm       , Md          , Ms          , Ms          , Ms          , Md          , Ms          , Md          , Ms          , Ms          , Ms^Xm       , Ms          , Ms^Xm       , Ms^Xm       , Mm^Xm       , Ms          , Mm^Xm       , Md          , Md          , Md          , Md          , Md          , Re          , Re          , Md          , Hh          , Md          , Md          , Hh          , Hh          , Hh          , Md          , Ms          
Gg          , Md          , Mm          , Md          , Mm          , Md          , Mm          , Md          , Hh          , Md          , Gg          , Hh          , Md          , Ms          , Md          , Ms          , Md          , Ms          , Mm          , Md          , Hh          , Hh          , Hh          , Hh          , Hh          , Md          , Re          , Mm          , Gg          , Hh          , Gg          , Hh          , Gg          , Hh          , Gg          , Ww          
