border_size=1
usage=map

Ww, Ww, Ww, Ww, Ww, Ww, Ss, Hh, Hh, Hh, Ss, Mm, Ss, Ww, Ss, Ss, Ss, Gg, Ss, Gg, Ss, Mm, Hh, Mm^Xm, Mm^Xm, Hh, Hh, Ww, Wo, Ss, Hh, Ss, Mm, Hh, Ss, Ss, Hh, Ss, Ss, Ww, Ww, Mm, Hh, Ss, Ww, Ss, Chs, Chs, Ss, Hh, Ss, Ss, Ss, Ww, Wo, Mm^Xm, Mm^Xm, Mm, Ms^Xm, Ms^Xm, Ms^Xm, Ms, Ms, Ms, Ms^Xm, Ms, Ms^Xm, Gg, Ms^Xm, Ms^Xm, Ms^Xm, Ms, Ms, Ms, Ms, Ms^Xm, Ms^Xm, Gg, Ms^Xm, Mm, Mm, Mm
Ss, Ww, Ss, Ww, Mm, Ss, Hh, Hh, Mm, Hh, Mm, Hh, Mm, Ww, Ss, Ss, Mm, Hh, Mm, Mm, Mm, Mm, Mm^Xm, Mm^Xm, Ms^Xm, Mm^Xm, Mm^Xm, Mm, Wo, Wo, Mm^Xm, Hh, Mm, Hh, Chs, Chs, Hh, Ss, Mm, Mm, Ms, Ms, Ww, Ww, Hh, Chs, Khs, Chs, Md, Hh, Hh, Ss, Hh, Ss, Mm^Xm, Ww, Ww, Ms, Ms, Ms^Xm, Ms^Xm, Ms^Xm, Ms^Xm, Ms^Xm, Ms, Ms, Ms^Xm, Ms^Xm, Ms^Xm, Wo, Ms^Xm, Ms^Xm, Ms^Xm, Ms^Xm, Ms^Xm, Ms^Xm, Ms^Xm, Ms^Xm, Ms, Ms^Xm, Ms^Xm, Mm
Gg, Ss, Hh, Hh, Mm, Mm, Mm, Mm, Mm, Mm, Mm, Hh, Hh, Ww, Ww, Hh, Mm, Mm, Mm^Xm, Mm, Mm^Xm, Mm^Xm, Mm^Xm, Ms^Xm, Ms^Xm, Ms^Xm, Mm^Xm, Mm^Xm, Ww, Mm, Mm^Xm, Mm, Gg^Efm, Mm, Khs, Chs, Mm, Mm, Ms, Ms, Ms, Ms, Ms^Xm, Hh, Md, Ss, Mm, Md, Mm^Xm, Gg, Mm^Xm, Mm, Mm^Xm, Mm^Xm, Mm, Hh, Hh, Ww, Ms, Ms, Ms, Ms^Xm, Ms, Ms, Ms^Xm, Ms^Xm, Ha, Ms^Xm, Ha, Ms^Xm, Ms^Xm, Hh, Ms^Xm, Ms^Xm, Ms^Xm, Ms^Xm, Ms^Xm, Ms, Ms, Ms^Xm, Ms^Xm, Mm
Gg, Gg^Efm, Mm, Mm, Mm^Xm, Mm^Xm, Mm^Xm, Mm^Xm, Mm, Mm, Mm, Mm, Ms, Ms, Ww, Mm, Mm^Xm, Mm^Xm, Mm, Mm^Xm, Mm, Ms, Md, Mm^Xm, Mm^Xm, Mm^Xm, Mm^Xm, Ww, Mm^Xm, Mm^Xm, Mm^Xm, Gg, Mm^Xm, Mm, Mm, Mm, Hh, Ms, Ms, Ms, Ms^Xm, Ms^Xm, Ms, Md, Md, Gg^Efm, Md, Md, Mm^Xm, Mm^Xm, Ms^Xm, Mm^Xm, Mm^Xm, Hh, Mm^Xm, Mm, Ms^Xm, Ms, Ms^Xm, Ms^Xm, Ms^Xm, Ms^Xm, Mm^Xm, Mm^Xm, Mm^Xm, Mm, Mm^Xm, Mm^Xm, Mm^Xm, Wo, Ms^Xm, Ms^Xm, Hh, Ms^Xm, Ms^Xm, Ms^Xm, Ms^Xm, Ms, Ms^Xm, Ms, Ms^Xm, Mm
Gg, Hh, Mm^Xm, Mm^Xm, Hh, Gg, Hh, Mm^Xm, Mm^Xm, Mm, Mm, Mm, Mm^Xm, Ms, Mm^Xm, Mm^Xm, Mm^Xm, Mm^Xm, Mm, Mm, Mm, Hh, Hh^Fp, Mm, Mm, Wo, Ms, Ms^Xm, Ms^Xm, Ms^Xm, Ms^Xm, Ms^Xm, Ms^Xm, Mm^Xm, Mm^Xm, Hh, Mm^Xm, Hh, Mm^Xm, Mm^Xm, Mm^Xm, Mm^Xm, Ms^Xm, Ms^Xm, Mm^Xm, Hh, Mm^Xm, Mm^Xm, Md, Mm^Xm, Mm^Xm, Ms^Xm, Ms^Xm, Hh, Ms^Xm, Ms^Xm, Ms^Xm, Ms^Xm, Hh, Mm, Mm, Hh, Hh, Mm, Mm, Mm, Ww, Gg^Efm, Ww, Wo, Hh, Ms^Xm, Ms^Xm, Ms^Xm, Wo, Ms^Xm, Ha, Ms^Xm, Ms, Ms, Ms^Xm, Mm
Md, Mm, Mm^Xm, Mm, Gg^Efm, Mm, Mm, Hh, Hh, Mm, Mm^Xm, Mm, Mm^Xm, Mm^Xm, Mm^Xm, Mm^Xm, Mm^Xm, Mm, Mm, Mm, Hh^Fp, Hh, Hh^Fp, Mm, Ms^Xm, Mm, Mm^Xm, Mm^Xm, Md, Ms^Xm, Md, Ms, Wo, Ms^Xm, Ms^Xm, Ms^Xm, Ms^Xm, Ms^Xm, Ms^Xm, Ms^Xm, Ms^Xm, Ms^Xm, Mm^Xm, Ms^Xm, Mm^Xm, Mm^Xm, Md, Rb, Mm, Md, Mm^Xm, Mm^Xm, Md, Mm^Xm, Mm^Xm, Mm, Mm, Hh, Mm, Mm, Hh, Mm, Hh, Hh, Wo, Ww, Ww, Wo, Hh, Mm^Xm, Mm^Xm, Ms^Xm, Ms^Xm, Ms^Xm, Ms^Xm, Wo, Mv, Ms^Xm, Ms, Ms^Xm, Mm, Mm
Hh, Hh, Hh, Gg, Mm, Mm, Mm, Mm^Xm, Mm^Xm, Mm^Xm, Rb, Mm^Xm, Hh, Mm^Xm, Mm^Xm, Mm^Xm, Mm, Mm, Mm, Mm, Gs^Fds, Mm, Gg^Efm, Mm, Mm^Xm, Mm, Md, Ms, Ms, Ms, Md, Ms, Wo, Ms, Ms, Ms^Xm, Ms, Ms^Xm, Ms^Xm, Mm^Xm, Ms, Mm^Xm, Md, Mm^Xm, Md, Md, Md, Rb, Rb, Md, Mm^Xm, Md, Md, Hh, Hh, Hh, Gg, Hh, Gg, Gg, Gg, Hh, Ww, Ww, Wo, Ss, Ss, Ss, Ss, Hh, Mm, Mm, Mm^Xm, Ms^Xm, Wo, Wo, Ms^Xm, Ms, Mm^Xm, Mm^Xm, Mm^Xm, Mm^Xm
Hh, Mm, Mm^Xm, Mm^Xm, Mm, Mm, Mm^Xm, Mm^Xm, Mm, Hh, Hh, Rb, Rb, Mm, Hh, Mm^Xm, Mm, Mm, Mm, Hh, Gs^Fds, Gs^Fds, Gs^Fms, Gs^Fms, Gs^Fms, Gs^Fms, Mm, Hh, Hh, Hh, Gs^Fds, Md, Gs^Fds, Wo, Mm, Ms, Hh, Mm, Hh^Fp, Ms, Mm, Md, Hh^Fms, Mm^Xm, Hh, Hh, Mm, Md, Rb, Mm, Mm^Xm, Hh, Mm, Mm, Mm, Gg, Gg^Efm, Gg, Gg, Ss, Wo, Wo, Ss, Wo, Ss, Ss, Sm, Gg^Efm, Ss, Mm, Hh, Hh, Mm, Ms^Xm, Mm^Xm, Mm^Xm, Mm, Mm^Xm, Mm, Mm, Mm, Mm
Mm, Mm, Mm^Xm, Mm^Xm, Mm, Mm^Xm, Mm, Mm, Gs^Fds, Gs^Fms, Gs^Fds, Gg, Gs^Fds, Rb, Rb, Mm, Gg, Hh, Hh, Gg, Gs^Fds, Gs^Fds, Gs^Fds, Gs^Fms, Gs^Fds, Gg, Hh, Gg, Gs, Hh, Hh, Gg, Gs^Fds, Wo, Ww, Hh^Fds, Gg, Gg, Hh, Hh, Hh, Hh, Mm, Mm^Xm, Mm^Xm, Mm, Gg, Mm, Rb, Mm, Mm, Mm^Xm, Mm, Mm, Mm, Hh, Hh, Gg, Gg, Gg, Ww, Ss, Gg, Ss^Vhs, Ss, Ss, Ss, Ss, Gg, Gg, Mm, Mm, Mm^Xm, Mm^Xm, Mm, Mm, Mm, Mm, Mm, Mm, Mm, Mm
Mm, Mm^Xm, Hh, Mm, Mm^Xm, Mm^Xm, Gs^Fds, Gs^Fds, Gs^Fds, Gg, Gs^Fds, Gs^Fms, Gs^Fds, Gs^Fms, Gg, Rb, Re, Gs^Fds, Gg, Hh, Gs^Fds, Gg, Gs^Fds, Gs^Fms, Gs^Fms, Gs^Fds, Mm, Gs^Fms, Gs, Mm, Hh, Gs^Fds, Gg, Wo, Wo, Hh, Hh, Mm, Hh, Gg, Gg, Mm, Hh^Vhh, Mm, Mm, Gg, Hh, Mm, Rb, Hh, Hh, Hh, Gg, Hh, Hh, Hh, Gg, Gg, Wo, Ww, Gg, Hh, Hh, Ss, Hh, Hh, Hh, Sm, Mm, Hh, Mm^Xm, Mm^Xm, Mm^Xm, Mm, Mm^Xm, Mm, Mm, Mm, Uh, Mm, Uh, Mm
Hh, Hh, Mm, Mm, Mm^Xm, Mm, Gs^Fms, Gs^Fds, Gs^Fms, Gs^Fds, Hh, Gs^Fms, Hh^Fds, Hh^Fds, Gs^Fds, Gs^Fds, Gs^Fds, Re, Gs^Fds, Gs^Fds, Gs^Fms, Hh^Fds, Gs^Fms, Hh^Fds, Gs^Fds, Gs^Fds, Hh, Gs^Fms, Gs^Fds, Gs^Fds, Gg, Hh, Gs^Fds, Gg, Wo, Gg, Gg, Hh, Gg, Gg, Gs, Gg, Gg, Hh, Hh, Gg, Gg, Gg, Rb, Gg, Gg, Gg, Gs, Gg, Hh, Gg, Gg, Gg, Wo, Ww, Ms^Xm, Ms^Xm, Ms^Xm, Ss, Hh, Mm, Mm, Hh, Hh, Mm^Xm, Mm^Xm, Mm^Xm, Ms, Ms^Xm, Ms, Mm^Xm, Xu, Uh, Ql, Ql, Ql, Ql
Gg, Mm, Mm, Mm, Mm^Xm, Mm, Gs, Gs^Fds, Hh, Gs^Fms, Hh^Fds, Gg^Efm, Gs^Fds, Gg, Gs^Fds, Gs^Fms, Gs^Fms, Re, Gs^Fms, Gs^Fms, Gs^Fds, Gs^Fds, Gg^Efm, Gs^Vl, Gs, Gs^Fms, Gs^Fms, Gs, Gs^Fds, Gs^Fds, Gs^Fds, Gs, Gg, Wo, Hh, Hh, Hh, Hh, Gg, Gg, Gs, Gs, Gg, Gs, Hh, Gs, Gg, Gg, Re, Gs, Gg, Gg, Gs, Gg, Gg, Gg, Gg, Gg, Ww, Hh, Hh, Ms^Xm, Mm, Hh, Ms^Xm, Mm, Ms^Xm, Mm, Ms^Xm, Ms^Xm, Mm, Ms, Ww, Ms, Mm, Mm^Xm, Ql, Ql, Xu, Xu, Xu, Xu
Gg, Hh, Mm, Mm^Xm, Mm^Xm, Hh, Gs^Fds, Gs^Fds, Gs, Hh, Gs^Fms, Hh^Fds, Gs^Fds, Hh, Gs^Fds, Gs^Fms, Gg, Rb, Gs^Fms, Gs^Fms, Ce, Ke, Ce, Gg, Gs^Fds, Gll^Fp, Gs^Fds, Gs^Fds, Gs^Fms, Gs^Fds, Gg, Gs^Fds, Wo, Wo, Gg, Gg, Gg, Gs, Gg, Gg, Gs, Gg, Gs, Gs, Gs, Gs, Gs, Gg, Re, Gs, Gs, Gs, Gs, Gs, Gg, Hh, Hh, Ww, Wo, Gg, Gg, Hh, Gg, Hh, Hh, Ms^Xm, Hh, Ms^Xm, Mm^Xm, Gg^Efm, Wo, Ww, Mm, Ms, Ql, Ql, Xu, Xu, Urb, Urb, Urb, Urb
Hh, Hh, Mm^Xm, Mm^Xm, Mm, Hh, Gs^Fms, Hh^Fds, Gs^Fds, Gs^Fms, Gs^Fds, Gs^Fms, Gs^Fms, Gs^Fds, Gs^Fms, Hh, Hh^Fds, Rb, Rb, Rb, Gs^Fms, Ce, Gs^Fds, Gs^Fds, Gll^Fp, Gs^Fds, Gg^Efm, Gs^Fms, Gg, Gg, Gs^Fds, Wo, Gs^Fms, Gs^Fds, Gg, Gg, Gg, Gs, Gg, Gs, Gs, Gs, Gs, Gs, Gs, Gs, Gg, Gg, Rb, Gg, Gs, Gg, Gg, Gg, Gg, Gg, Ww, Wo, Gg, Gg, Gg, Gg, Gg, Gg^Efm, Gg, Hh, Mm^Xm, Mm^Xm, Md, Hh, Wo, Mm, Mm, Mm, Xu, Xu, Urb, Urb, Urb, Urb, Urb, Cud
Hh, Mm, Mm^Xm, Mm, Mm, Hh, Hh, Gs^Fms, Gs^Fms, Gs^Fms, Gs^Fms, Gs^Fds, Gs^Fms, Gs^Fds, Gs^Fds, Gs^Fms, Gg, Rb, Gs^Fds, Hh, Gs^Fds, Gs^Fds, Gs^Fms, Gs^Fms, Gs^Fms, Gg, Wo, Gs^Fms, Ww, Gg, Wo, Wo, Gg, Gg, Gg, Gg, Gg, Gs, Gg, Gg, Gg, Gs, Gs, Gs, Gg, Gs, Gs, Gg, Rb, Gg, Gg, Gs, Gs, Gs, Gs, Gg, Wo, Gg, Gg, Gg, Gg, Gg, Hh, Gg, Mm, Hh^Vhh, Mm^Xm, Mm^Xm, Mm, Wo, Hh, Gg, Mm, Xu, Urb, Urb, Urb, Urb, Urb, Urb, Urb, Cud
Hh, Mm^Xm, Mm^Xm, Hh, Mm, Gs^Fms, Gs^Fms, Gs^Fms, Gs^Fds, Gs^Vl, Hh^Fds, Gs^Fms, Gs^Fds, Gs^Fms, Hh^Fds, Gs^Fds, Gs^Fds, Rb, Gg, Gs^Fms, Gs^Fds, Gs^Fms, Gs^Fms, Gg, Ww, Wo, Ww, Ww, Wo, Wo, Ww, Gg, Gg, Gg, Gg, Gg, Gg, Gg, Gs, Gg, Gs, Gs, Gs, Gg, Gg, Gs, Re, Gg, Rb, Gs, Gs, Gg, Gs, Gs, Gg, Ww, Gg, Gg, Gs, Gg, Hh, Gg, Hh, Mm, Mm^Xm, Mm^Xm, Mm, Mm, Ww, Ww, Gg^Efm, Mm, Mm^Xm, Xu, Xu, Urb, Urb, Urb, Urb, Urb, Urb, Urb
Gg, Hh, Mm, Mm^Xm, Wo, Mm, Mm, Gs^Fms, Gs^Fds, Gs^Fds, Gs^Fds, Gs^Fds, Gs^Fms, Gs^Fms, Gs^Fds, Gs, Gs^Fms, Rb, Gs^Fds, Gs^Fms, Gs^Fms, Gs^Fms, Ww^Ewl, Ww, Ww, Wo, Wo, Ww, Wo, Wo, Wo, Gg, Gg, Gg, Gg, Gg, Gg, Gg, Gg, Gg, Gg, Gs, Gg, Gg, Rb, Rb, Ce, Rb, Rb, Gs^Vh, Gg, Gg, Gs, Gg, Gg, Ww, Gg, Gg, Gs, Gg, Gg, Mm, Hh, Hh, Mm^Xm, Mm^Xm, Mm, Hh, Ww, Hh, Mm, Mm, Mm^Xm, Xu, Urb, Xu, Xu, Urb, Urb, Urb, Urb, Urb
Gg, Hh, Hh, Mm^Xm, Mm^Xm, Hh^Fms, Hh^Fms, Mm, Gs^Fds, Gg, Gs^Fds, Gg, Gg, Gs^Fms, Gs^Fds, Gs^Fms, Gs^Fds, Rb, Gs^Fds, Gs^Fms, Gs^Fds, Gs^Fds, Ww, Ww, Gs^Fds, Ww, Wo, Gs^Vc, Wo, Wo, Wo, Gg, Gg, Gg, Gg, Gg, Gg, Gg, Gg, Gg, Rb, Gs, Re, Rb, Hh, Ce, Ke, Ce, Hh, Rb, Rb, Gg, Gg, Gg, Ww, Ww, Gs, Gg, Gs, Gs, Gg, Gg, Hh, Mm^Xm, Mm, Mm, Rr, Ww, Gg, Mm, Hh, Mm, Mm, Cud, Urb, Urb, Urb, Xu, Urb, Urb, Xu, Urb
Gg, Gg^Efm, Mm, Mm, Mm^Xm, Hh^Fms, Wo, Wo, Wo, Gs^Fds, Ww, Ww, Wo, Wo, Wo, Ww, Wo, Wo^Bw|, Wo, Gg, Wo, Wo, Wo, Gg^Efm, Wo, Wo, Wo, Ww, Wo, Wo, Ww, Ww, Ww, Gg, Ww, Gg, Gg, Gg, Rb, Rb, Rb, Re, Hh, Gg, Hh, Mm, Hh, Mm, Mm, Hh, Hh, Rb, Rb, Gg, Wo, Gg, Gs, Gg, Gg, Gg, Gg, Hh, Mm^Xm, Mm^Xm, Rr, Rr, Ww, Wwf^Bsb\, Rr, Hh, Rr, Rr, Rr, Urb, Urb, Urb, Urb, Urb, Urb, Xu, Xu, Urb
Ss, Ss, Wo, Mm, Wo, Mm^Xm, Wo, Wo, Ww, Wo, Wo, Wo, Ww, Wo, Gg, Wo, Gg, Wo^Bw|, Ww, Wo, Gg, Ww, Gg, Wo, Ww, Ww, Ww, Wo, Ww, Ww, Ww, Ww, Gg, Ww, Gs^Vc, Ww, Ww^Bw/, Rb, Ww, Gg, Ww, Gg, Ww, Ww, Hh, Mm, Gg, Mm, Hh, Mm, Hh, Gg, Ww, Ww^Bw\, Rb, Gg, Gs, Gs, Gs, Gg, Hh, Hh^Vhh, Mm^Xm, Ch, Rr, Hh, Wo, Gg, Rr, Rr, Hh, Hh, Xu, Cud, Urb, Urb, Urb, Urb, Urb, Urb, Urb, Xu
Wo, Wo, Wo, Wo, Wo, Mm^Xm, Hh, Hh, Hh^Vhh, Gg, Gg, Gg, Gg, Gg, Gg, Gg, Gs, Rb, Gg, Ww, Ww, Ww, Ww, Gg, Ww, Gg, Ww, Gg, Ww, Ww, Gg, Gg, Gg, Gg, Rb, Rb, Gg, Ww, Gg, Ww, Gg, Ww, Gg, Ww, Ww, Ww, Ww, Hh, Wo, Gs^Vc, Wo, Ww, Gg, Ww, Gg, Rb, Re, Gg, Gs, Gg, Gg, Mm^Xm, Rb, Rb, Ch, Ww, Gg, Gg, Rr, Gs, Hh, Mm, Mm, Xu, Urb, Urb, Urb, Urb, Urb, Urb, Urb, Xu
Wo, Wo, Gg^Efm, Wo, Hh, Mm^Xm, Ch, Hh, Gg, Gg, Gg, Gg, Gs, Gg, Gs, Gs, Gg, Re, Gg, Gg, Gg, Ww, Gg, Ww, Gg, Ww, Gg, Ww, Gg, Gg, Gg, Gg, Re, Rb, Gg, Rb, Gs, Gg, Gg, Gg, Gs, Gg, Gs, Gg, Gg, Ww, Ww, Ww, Ww, Ww, Gg, Gg, Gg, Gg, Gs, Gs, Gg, Re, Rb, Gg, Rb, Rb, Gg, Gg, Ww, Ww, Ch, Rr, Kh, Mm^Xm, Mm^Xm, Mm, Mm^Xm, Xu, Xu, Urb, Xu, Urb, Xu, Urb, Urb, Xu
Gg, Hh, Hh, Hh, Hh, Mm^Xm, Rb, Rb, Rb, Rb, Re, Re, Re, Gg, Rb, Gs, Re, Rb, Gs, Gs, Gg, Gs, Gg, Gg, Gg, Gg, Rb, Gg, Rb, Gg, Rb, Re, Gs, Gs, Gs, Re, Gs, Gg, Gs, Gs, Gg, Gs, Gs, Gs, Gg, Gg, Gg, Hh, Mm, Ww, Ww, Ww, Ww, Gg, Ww, Gg, Gg, Gg, Gg, Rb, Gg, Gg, Wo, Ww, Mm, Hh, Gg, Rb, Hh, Mm, Mm, Mm^Xm, Mm, Mm, Xu, Xu, Xu, Xu, Urb, Xu, Urb, Urb
Gg, Gg, Gg, Gg, Mm^Xm, Mm^Xm, Ch, Gs, Gs, Gg, Gs, Gs, Gg, Rb, Hh, Rb, Gs^Vh, Re, Rb, Rb, Rb, Rb, Rb, Rb, Rb, Rb, Hh, Rb, Mm, Rb, Gg, Gs, Gg, Gg, Hh, Re, Gs, Gg, Gs, Hh, Gg, Gg, Gs, Gg, Gg, Hh, Gg, Hh, Mm, Gg, Mm, Gg, Hh, Ww, Ww, Ww, Ww, Gg, Ww, Wo, Ww, Wo, Wo, Ww, Gg, Mm, Gg, Rb, Gg, Hh, Mm, Mm, Mm, Mm, Mm, Xu, Xu, Urb, Urb, Urb, Urb, Urb
Hh, Hh, Mm, Mm^Xm, Mm, Mm^Xm, Hh, Gg, Hh^Vhh, Hh, Ch, Ch, Ch, Hh, Mm, Mm, Hh, Gs, Gg, Gg, Gs, Hh, Mm, Gg, Mm, Hh, Mm, Gg, Mm^Xm, Mm, Hh, Gs, Gg, Gs, Hh, Rb, Gs, Gs, Gs, Gs, Gg, Gs, Gs, Hh, Hh, Mm, Hh, Mm, Mm^Xm, Mm, Mm^Xm, Hh, Mm^Xm, Hh, Hh, Gg, Gg, Ww, Gg, Ww, Gg, Ww, Mm^Xm, Wo, Wo, Wo, Wo, Rb, Gg, Gg, Gg, Mm, Mm, Mm, Mm, Ql, Xu, Urb, Urb, Urb, Urb, Urb
Hh, Hh, Mm, Mm^Xm, Mm, Mm^Xm, Mm^Xm, Mm, Mm, Mm, Hh, Kh, Hh, Mm, Mm, Hh, Gg, Gg, Mm, Mm, Mm, Hh, Hh, Hh, Mm^Xm, Mm^Xm, Mm^Xm, Mm^Xm, Mm^Xm, Mm, Mm, Hh, Mm, Hh, Gg, Re, Gg, Gg, Gs, Gs, Gs, Gs, Gg, Hh, Mm, Hh, Mm, Mm^Xm, Mm, Mm^Xm, Mm, Mm^Xm, Mm, Mm^Xm, Mm^Xm, Hh, Gg, Ss, Hh, Hh, Hh, Mm, Mm^Xm, Wo, Gg, Ss, Ss, Wo^Bw|, Wo, Hh, Hh, Hh, Mm, Mm, Mm, Ql, Xu, Xu, Urb, Urb, Urb, Urb
Mm, Mm^Xm, Ms, Mm, Mm, Mm^Xm, Wo, Mm^Xm, Mm^Xm, Mm, Hh, Gg, Mm, Mm, Mm^Xm, Mm, Mm, Mm, Hh, Hh, Hh, Hh, Mm^Xm, Mm^Xm, Mm, Mm, Ms^Xm, Mm, Mm, Mm^Xm, Gg, Hh, Hh, Gg, Hh, Rb, Rb, Gg, Gs, Gg, Gs, Gs, Hh, Gg, Hh, Hh, Mm^Xm, Mm^Xm, Mm, Mm, Ms^Xm, Mm, Mm, Mm, Mm^Xm, Mm, Hh, Hh, Hh, Gg, Mm, Mm, Mm^Xm, Mm, Hh, Hh, Gg, Rb, Ww, Wo, Wo, Gg, Mm, Mm, Mm, Ql, Ql, Xu, Xu, Urb, Xu, Urb
Ms, Mm^Xm, Ms, Mm, Ms^Xm, Mm^Xm, Mm^Xm, Wo, Mm^Xm, Mm, Mm^Xm, Mm^Xm, Mm^Xm, Mm^Xm, Mm^Xm, Mm^Xm, Mm^Xm, Hh, Mm^Xm, Hh, Wo, Hh^Fms, Mm^Xm, Mm, Mm, Ms^Xm, Mm, Ms^Xm, Ms^Xm, Mm^Xm, Mm^Xm, Mm, Hh, Gg, Mm, Hh, Mm, Rb, Hh, Gg, Hh, Gs^Es, Hh^Vhh, Mm, Mm, Mm^Xm, Mm, Mm, Mm, Ms^Xm, Ms^Xm, Ms^Xm, Mm, Mm, Hh^Fp, Hh, Mm^Xm, Hh^Vhh, Mm, Gg, Gg, Ms^Xm, Mm, Hh, Ms^Xm, Mm, Hh, Rb, Rb, Ww, Wo, Ww, Wo, Hh, Mm, Mm, Mm, Ql, Ql, Xu, Ql, Xu
Mm^Xm, Mm^Xm, Ms, Ms, Mm, Mm, Mm, Mm^Xm, Mm^Xm, Mm^Xm, Mm, Mm^Xm, Mm, Mm^Xm, Ms^Xm, Mm^Xm, Ms^Xm, Mm^Xm, Mm^Xm, Mm^Xm, Mm^Xm, Mm^Xm, Mm, Mm, Mm, Ms^Xm, Mm, Ms^Xm, Mm, Mm, Mm^Xm, Mm^Xm, Mm, Hh, Hh, Hh, Mm, Rb, Hh, Mm, Mm, Hh, Hh, Gg^Efm, Mm^Xm, Mm^Xm, Ms^Xm, Ms^Xm, Ms^Xm, Ms^Xm, Mm, Ms^Xm, Mm, Wo, Wo, Mm, Mm^Xm, Mm, Hh, Hh, Mm^Xm, Ms^Xm, Ms^Xm, Ms^Xm, Mm, Ms^Xm, Ms^Xm, Ms^Xm, Ms^Xm, Rb, Rb, Wo, Md, Wo, Wo, Mm, Mm, Mm, Mm, Ql, Mm, Ql
Ms, Ms, Ms, Hh, Mm, Hh^Fms, Gs^Es, Mm, Mm^Xm, Ms^Xm, Mm^Xm, Mm^Xm, Ww, Ms^Xm, Mm, Ms^Xm, Mm, Ms^Xm, Mm, Mm, Mm, Mm, Mm, Ms^Xm, Mm, Ms^Xm, Ms^Xm, Ms^Xm, Mm, Hh^Fds, Mm, Mm^Xm, Mm, Mm, Hh, Gg, Rb, Rb, Gg, Hh, Gg, Mm, Mm, Mm^Xm, Mm, Ms^Xm, Ms^Xm, Ms^Xm, Mm, Ha, Ha, Ms^Xm, Ms^Xm, Mm, Ms^Xm, Mm, Mm, Mm^Xm, Mm^Xm, Mm^Xm, Mm, Mm^Xm, Mm, Mm, Hh, Mm, Mm, Mm, Hh, Mm^Xm, Mm^Xm, Rb, Rb, Wo, Mm, Ww, Ms, Ms, Ms, Mm, Mm, Mm
Ww, Ms, Hh, Mm^Xm, Hh, Hh^Fms, Hh, Gs, Hh, Mm^Xm, Hh, Ww, Ms^Xm, Mm, Mm, Hh, Mm, Ms^Xm, Ms^Xm, Ms^Xm, Ms^Xm, Ms^Xm, Ww, Ww, Mm, Ms^Xm, Ms^Xm, Ms^Xm, Hh, Hh, Mm, Mm^Xm, Mm^Xm, Hh, Mm, Rb, Mm, Hh, Hh, Gg, Mm, Gg, Mm^Xm, Mm^Xm, Mm, Mm, Ms^Xm, Mm, Mm, Ww, Ms^Xm, Ms^Xm, Ms^Xm, Ms^Xm, Ms^Xm, Ms^Xm, Ms^Xm, Ms^Xm, Ms^Xm, Hh, Gg, Mm, Hh, Mm, Hh, Hh, Mm, Mm^Xm, Mm^Xm, Mm^Xm, Hh, Mm^Xm, Ms^Xm, Ww, Ms, Ww, Ms, Ms^Xm, Ms, Mm, Ms^Xm, Hh
Wo, Hh, Gg, Gg, Hh, Hh, Hh, Gg, Hh, Mm, Ww, Ww, Mm, Ms^Xm, Mm, Mm, Hh^Fds, Mm, Hh, Mm, Ww, Ww, Mm, Mm, Ms^Xm, Mm, Mm, Ms^Xm, Ms^Xm, Gg, Gg^Efm, Hh, Mm, Mm^Xm, Mm, Rb, Mm, Mm, Mm, Mm, Mm, Mm, Mm^Xm, Mm, Ms^Xm, Ms^Xm, Mm, Ms^Xm, Ms^Xm, Ww, Hh, Ms^Xm, Mm, Ww, Ww, Mm, Mm, Ms^Xm, Hh, Ww, Hh, Mm, Mm, Mm, Mm, Mm, Wo, Mm, Hh, Mm, Mm, Mm, Hh, Ms^Xm, Ms^Xm, Wo, Ms^Xm, Ms, Ms^Xm, Ms^Xm, Ms^Xm, Ms^Xm
Hh, Mm, Mm, Gs, Hh, Mm, Ss, Gg, Gg, Ss, Ww, Gg, Rb, Hh, Rb, Hh, Gg, Mm, Ww, Ww, Mm, Ms^Xm, Ms^Xm, Mm, Ms^Xm, Mm, Ms^Xm, Ms^Xm, Ww, Ms^Xm, Ms^Xm, Hh, Mm, Mm^Xm, Mm^Xm, Rb, Mm^Xm, Mm, Mm^Xm, Mm, Mm^Xm, Mm^Xm, Mm, Mm, Ms^Xm, Mm, Ms^Xm, Ms^Xm, Ms^Xm, Ww, Ww, Ms^Xm, Ms^Xm, Ww, Mm, Ms^Xm, Ms^Xm, Mm, Ww, Ww, Mm, Hh, Mm, Mm, Mm, Hh, Hh, Mm, Mm, Hh, Hh, Hh, Mm, Mm, Mm, Mm, Mm, Ms^Xm, Mm, Hh, Hh, Hh
Wo, Mm, Gg^Efm, Gg, Gg, Hh, Ww, Wwf, Wo, Ww, Sm, Rb, Hh, Rb, Mm, Hh, Ww, Ww, Hh, Mm, Mm, Mm, Ms^Xm, Ms^Xm, Ms^Xm, Ms^Xm, Ms^Xm, Ms^Xm, Mm, Ww, Ha, Ms^Xm, Mm, Ms^Xm, Ms^Xm, Mm^Xm, Ms^Xm, Ms^Xm, Mm, Ms^Xm, Ww, Mm^Xm, Mm, Mm, Ms^Xm, Mm, Mm, Hh, Ms^Xm, Ms^Xm, Ww, Ms^Xm, Ms^Xm, Ww, Mm, Ms^Xm, Hh, Mm, Ww, Mm, Ms^Xm, Mm, Mm, Mm, Mm, Mm, Mm, Mm, Mm, Hh, Mm, Mm, Mm, Mm, Mm, Mm, Mm, Mm, Hh, Mm, Mm, Mm
Hh, Ww, Wwf, Gg, Ss, Ww, Gg, Gg, Rb, Sm, Ss, Ss, Gg, Hh, Ss, Ss, Ww, Ss, Hh, Gg, Ms^Xm, Ms^Xm, Ms^Xm, Mm, Ms^Xm, Ms^Xm, Mm, Mm, Ms^Xm, Ww, Ww, Mm, Hh, Mm, Ms^Xm, Hh, Hh, Mm, Ms^Xm, Ms^Xm, Ww, Ms^Xm, Ms^Xm, Mm, Mm, Mm, Hh, Hh, Hh, Hh, Ww, Hh, Gg^Efm, Ww, Hh, Hh, Mm, Mm, Ww, Ms^Xm, Mm, Ms^Xm, Ms^Xm, Ms^Xm, Mm, Mm, Mm, Mm, Mm, Hh, Hh, Mm, Mm, Mm, Mm, Mm, Hh, Hh, Mm, Mm, Mm, Hh
Mm, Hh, Gg, Ww, Gg, Ww, Ss^Vhs, Rb, Ss, Ss, Gg, Ss, Ss, Ss, Ss, Gg^Efm, Ww, Ss, Gg, Hh, Ms^Xm, Mm, Ms^Xm, Ms^Xm, Mm, Ms^Xm, Mm, Mm, Mm, Ms^Xm, Ss, Ww, Ww, Gg, Ms^Xm, Mm, Gg, Mm, Mm, Ms^Xm, Mm, Mm, Ms^Xm, Hh, Gg, Hh, Gg, Hh, Gg, Ss, Ss, Ww, Ss, Ww, Hh, Hh, Mm, Hh, Ww, Mm, Mm, Mm, Mm, Mm, Mm, Mm, Mm, Mm, Mm, Mm, Gg, Mm, Hh, Mm, Hh, Mm, Hh, Mm, Mm, Hh, Mm, Mm
