border_size=1
usage=map

Gg          , Gg          , Gg          , Gg          , Ww          , Wo          , Wo          , Wo          , Wo          , Wo          , Wo          , Wo          , Ww          , Ww          , Ww          , Ss          , Gg          , Ss          , Gg          , Ss          , Ss          , Ss          , Ww          , Ss          , Wo          , Ss          , Ww          , Wo          , Ss          , Ss          , Hh          , Mm          , Mm          , Gg          , Mm          , Gg          , Gg^Efm      , Hh          , Mm          , Mm          , Mm^Xm       , Mm          , Mm^Xm       , Mm          , Mm          , Mm          
Gg          , Gg          , Gg          , Gg          , Ww          , Wo          , Wo          , Wo          , Ww          , Wo          , Ww          , Wo          , Wo          , Wo          , Ss          , Ss          , Ss          , Ss          , Wo          , Wo          , Ww          , Wo          , Ss          , Ww          , Ss          , Ww          , Wo          , Ss          , Ss          , Ss          , Hh          , Mm          , Hh          , Mm          , Gg          , Gg          , Hh          , Mm          , Mm^Xm       , Mm^Xm       , Gg          , Mm^Xm       , Mm^Xm       , Mm          , Mm          , Mm          
Gg          , Gg          , Gg          , Ww          , Wo          , Wo          , Wo          , Wo          , Wo          , Ww          , Wo          , Wo          , Ww          , Wo          , Wo          , Ww          , Wo          , Ww          , Wo          , Ss          , Wo          , Ss          , Ww          , Sm          , Ss          , Ss          , Ss          , Wo          , Gg          , Gg          , Hh          , Hh          , Hh          , Mm          , Mm          , Mm          , Mm          , Mm^Xm       , Mm          , Hh          , Mm          , Hh          , Hh          , Mm^Xm       , Mm          , Mm          
Gs          , Gg          , Gg          , Ww          , Ww          , Wo          , Wo          , Wo          , Wo          , Wo          , Wo          , Wo          , Wo          , Wo          , Ss          , Ss          , Gg          , Wo          , Ss          , Ss          , Ss          , Ww          , Ss          , Ss          , Ss          , Gg          , Ss          , Ww          , Ss          , Ss          , Ss          , Hh          , Mm          , Hh          , Gg^Efm      , Md          , Gg          , Mm^Xm       , Gg          , Gg^Efm      , Mm          , Mm          , Mm^Xm       , Hh          , Mm^Xm       , Mm^Xm       
Gs          , Gs          , Gg          , Gg          , Gg          , Ww          , Wo          , Ww          , Wo          , Wo          , Wo          , Wo          , Wo          , Ss          , Ss          , Ss          , Ss          , Ss          , Ss          , Ss          , Wo          , Ww          , Ww          , Wo          , Ss          , Ss          , Ss^Vhs      , Ww          , Ss          , Ss          , Ww          , Gg          , Hh          , Hh          , Gg          , Hh          , Mm          , Hh          , Mm^Xm       , Mm          , Mm          , Mm          , Mm^Xm       , Mm^Xm       , Hh          , Rb          
Gs          , Gs          , Gg          , Gg          , Gg          , Ww          , Wo          , Wo          , Wo          , Wo          , Wo          , Wo          , Wo          , Ss          , Ss^Vhs      , Gg          , Wo          , Ss          , Ss          , Ww          , Ss          , Ss          , Ss          , Gg          , Ss          , Ss          , Wo          , Ss          , Ss          , Ss          , Wo          , Ss          , Hh          , Mm          , Hh          , Hh          , Mm          , Mm^Xm       , Mm^Xm       , Mm          , Mm^Xm       , Mm^Xm       , Mm          , Mm          , Gs^Fms      , Hh          
Gs          , Gs          , Gg          , Gg          , Gg          , Ww          , Wo          , Wo          , Wo          , Ww          , Wo          , Gg          , Wo          , Wo          , Ss          , Ss          , Wo          , Ss          , Sm          , Ww          , Ww          , Gg          , Ss          , Gg^Efm      , Ss          , Gg          , Wo          , Ss          , Ss          , Wo          , Ss          , Wo          , Hh          , Mm          , Mm          , Mm          , Mm^Xm       , Mm^Xm       , Mm          , Mm          , Mm^Xm       , Mm          , Gs^Fds      , Gs^Fds      , Gg          , Gs^Fds      
Gg          , Gg          , Gg          , Gg          , Rb^Vc       , Ww^Bw/      , Ww          , Ww          , Ww          , Gg          , Wo          , Ww          , Wo          , Ww          , Ww          , Ss          , Ss          , Ww          , Ww          , Ss          , Ss          , Wo          , Ss          , Ss          , Sm          , Ww          , Wo          , Ss          , Ss          , Gg          , Ss          , Gg          , Hh          , Ss          , Mm          , Mm          , Gg          , Hh          , Mm          , Mm^Xm       , Mm          , Gs^Fds      , Gs^Fds      , Gs^Fds      , Gs^Fds      , Gs^Fds      
Gg          , Gg          , Rb          , Rb          , Gg          , Gg          , Ww          , Ww          , Gg          , Ww          , Gg          , Ww          , Ww          , Wo          , Wo          , Ss          , Ss          , Ss          , Ss          , Wo          , Ss          , Ss          , Gg          , Ww          , Ss          , Ss          , Ss          , Wo          , Wo          , Ss          , Ss          , Hh          , Ss          , Hh          , Hh          , Hh          , Mm          , Mm          , Mm          , Mm^Xm       , Mm          , Gs^Fms      , Gs^Fds      , Gs^Fms      , Gs^Fms      , Hh          
Rb          , Gg          , Rb          , Gg          , Gg          , Gg          , Gg          , Ww          , Ww          , Ww          , Ww          , Ww          , Ww          , Ww          , Wo          , Ww          , Ww          , Ss          , Ss          , Wo          , Ss          , Ss          , Ss          , Ss          , Ss          , Wo          , Ss          , Gg          , Ss          , Wo          , Wo          , Hh          , Ss          , Ss          , Ss          , Ss          , Hh          , Mm          , Mm^Xm       , Mm^Xm       , Hh          , Gs          , Gs^Fds      , Hh          , Hh          , Hh^Fds      
Gg          , Rb          , Gg          , Gs          , Gg          , Gg          , Gg          , Gg          , Ww          , Ww          , Gg          , Gg          , Wo          , Wo          , Wo          , Wo          , Wo          , Wo          , Wo          , Ss          , Ww          , Ss          , Ss          , Ss          , Ss          , Ww          , Ss          , Ss          , Gg          , Ss          , Wo          , Ss          , Ss          , Hh          , Hh          , Ss          , Hh          , Mm          , Mm^Xm       , Mm^Xm       , Hh          , Gs^Fds      , Hh^Fds      , Gs          , Gs^Fms      , Gs^Fms      
Gg          , Rb          , Rb          , Gg          , Gg          , Gg          , Gg          , Gg          , Gg          , Ww          , Ww          , Ww          , Wo          , Ww          , Wo          , Ww          , Ww          , Ww          , Wo          , Ww          , Ww          , Wo          , Ss          , Ss          , Gg          , Ss          , Ww          , Ww          , Ss          , Ss          , Ss          , Wo          , Ss          , Ss          , Hh          , Gg          , Mm          , Mm^Xm       , Mm          , Mm          , Hh          , Gs^Fms      , Gs^Fms      , Gs^Fds      , Gs^Fms      , Gs^Fds      
Gs          , Gg          , Gg          , Rb          , Rb          , Gg          , Gg          , Gg          , Ww          , Ww          , Wo          , Wo          , Ww          , Ww          , Wo          , Wo          , Ww          , Gg          , Ww          , Wo          , Wo          , Wo          , Wo          , Ss          , Ww          , Ss          , Ss          , Ss          , Gg          , Ss          , Ss          , Wo          , Ss          , Ss          , Hh          , Hh          , Mm^Xm       , Mm^Xm       , Hh          , Mm          , Gs^Fms      , Hh          , Gs^Fms      , Gs^Fms      , Gs^Vl       , Gs^Fms      
Gs          , Gs          , Gg          , Gg          , Rb          , Gg          , Gg          , Gg          , Gg          , Ww          , Ww          , Wo          , Wo          , Gg          , Wo          , Wo          , Gg          , Ww          , Wo          , Gg          , Ww          , Ww          , Wo          , Wo          , Wo          , Ss          , Ss          , Ss          , Ss          , Ss          , Ww          , Wo          , Ss          , Ss          , Hh          , Gg          , Hh          , Mm^Xm       , Mm^Xm       , Mm          , Mm          , Gs^Fms      , Gs^Fms      , Gs^Fds      , Gs^Fds      , Hh^Fds      
Gg          , Gg          , Gg          , Gg          , Rb          , Rb          , Rb          , Gg          , Gg          , Ww          , Ww          , Ww          , Ww          , Ww          , Wo          , Wo          , Ww          , Wo          , Ww          , Wo          , Wo          , Wo          , Ww          , Gg          , Wo          , Ww          , Wo          , Ss          , Ww          , Ss          , Wo          , Ss          , Ss          , Ss          , Ss          , Hh          , Hh          , Mm          , Mm^Xm       , Wo          , Hh^Fms      , Mm          , Mm          , Gs^Fds      , Gg          , Gs^Fds      
Gg          , Gg          , Rb^Vh       , Rb          , Gg          , Gg          , Gg          , Rb          , Rb          , Gg          , Gg          , Ww          , Ww          , Ww          , Wo          , Wo          , Ww          , Gg          , Ww          , Ww          , Wo          , Wo          , Ww          , Ww          , Gg          , Wo          , Ss          , Wo          , Wo          , Ww          , Ww          , Ss          , Ss          , Ss          , Gg          , Hh          , Hh          , Hh          , Mm          , Mm^Xm       , Hh^Fms      , Hh^Fms      , Wo          , Gs^Fds      , Gs^Fds      , Gs^Fds      
Rb          , Rb          , Rb^Gvs      , Gg          , Gg          , Gg          , Gs          , Gg          , Rb          , Gg          , Gg          , Gg          , Wo^Bw/      , Wo          , Wo          , Ww          , Ww          , Ww          , Ww          , Wo          , Ww          , Ww          , Ww          , Ww          , Gg          , Ss          , Ss          , Ss^Vhs      , Wo          , Wo          , Wo          , Wo          , Ss          , Ss          , Ss          , Ss          , Ss          , Mm          , Mm          , Mm^Xm       , Mm^Xm       , Wo          , Wo          , Wo          , Wo          , Ww          
Rb^Gvs      , Rb^Gvs      , Rb^Gvs      , Rb^Gvs      , Rb^Gvs      , Gs          , Gg          , Gs          , Gg          , Rb          , Rb          , Gg^Vc       , Gg          , Ww          , Wo          , Ww          , Ww          , Gg          , Ww          , Ww          , Ss          , Gg          , Ss          , Ss          , Ss          , Ss          , Ss          , Gg^Efm      , Gg          , Gg          , Wo          , Wo          , Wo          , Gg          , Ss          , Gg          , Ww          , Wo          , Wo          , Wo          , Mm^Xm       , Wo          , Hh          , Ww          , Gg          , Wo          
Rb^Gvs      , Rb^Gvs      , Rb^Gvs      , Gg          , Rb^Gvs      , Gg          , Gg          , Gs          , Rb          , Gg          , Gg          , Rb          , Gg          , Ww          , Ww          , Wo          , Ww          , Ww          , Gg          , Gg          , Ss          , Gg          , Ss          , Ww          , Ss          , Ww          , Ww          , Ss          , Ss          , Ss          , Gg          , Wo          , Ww          , Ww          , Wo          , Ww          , Ww          , Wo          , Wo          , Wo          , Mm^Xm       , Hh          , Hh          , Hh^Vhh      , Gg          , Gg          
Rb^Gvs      , Rb^Gvs      , Rb^Gvs      , Rb^Gvs      , Rb^Gvs      , Rb^Gvs      , Gg          , Rb^Gvs      , Rb^Gvs      , Gg          , Gg          , Rb          , Rb          , Gg          , Gg          , Ww          , Gg          , Gg          , Ss          , Gg          , Ss          , Ss          , Gg^Efm      , Gg          , Ss          , Ss          , Ss          , Ss          , Ww          , Ss          , Ww          , Ww          , Ss          , Wo          , Wo          , Wo          , Gg          , Gg^Efm      , Hh          , Hh          , Mm^Xm       , Ch          , Rb          , Gg          , Rb          , Gg          
Rb^Gvs      , Rb^Gvs      , Rb^Gvs      , Rb^Gvs      , Rb^Gvs      , Rb^Gvs      , Rb^Gvs      , Rb^Gvs      , Rb^Gvs      , Gg          , Gg          , Gg          , Gg          , Rb          , Rr          , Ce          , Ce          , Gg          , Gg          , Ss          , Gg          , Gg          , Gg          , Gg          , Gg          , Ss          , Gg          , Ss          , Ss          , Ww          , Ww          , Ss          , Ss          , Gg          , Gg          , Gg          , Gg          , Hh          , Gg          , Hh          , Mm^Xm       , Rb          , Gs          , Rb          , Gg          , Re          
Rb^Gvs      , Rb^Gvs      , Rb^Gvs      , Rb^Gvs      , Hh          , Rb^Gvs      , Rb^Gvs      , Rb^Gvs      , Rb^Gvs      , Rb^Gvs      , Rb^Gvs      , Gg          , Rp          , Rr          , Rb          , 1 Ke        , Ce          , Gg          , Gg          , Gg          , Gg          , Gg          , Gg          , Gg          , Gg          , Gg          , Ss          , Ss          , Ss          , Ss          , Ww          , Ss          , Ss          , Ss          , Gg          , Gg          , Hh          , Gg          , Mm^Xm       , Mm^Xm       , Mm^Xm       , Ch          , Gg          , Gs          , Hh          , Gs          
Rb          , Rb^Gvs      , Rb^Gvs      , Rb^Gvs      , Rb^Gvs      , Rb^Gvs      , Rb^Gvs      , Rb^Gvs      , Rb^Gvs      , Rb^Gvs      , Rp          , Rp          , Rb^Gvs      , Rb          , Gg^Vh       , Rb          , Rb          , Gg          , Gg          , Gg          , Gg          , Gg          , Gg          , Gg          , Gg          , Gg          , Gg          , Gg          , Gg          , Ww          , Ww          , Ss          , Gg          , Gg          , Gg          , Hh          , Hh          , Mm          , Mm^Xm       , Mm          , Mm^Xm       , Hh          , Mm          , Hh^Vhh      , Mm          , Ch          
Rb^Gvs      , Rb^Gvs      , Rb^Gvs      , Rb^Gvs      , Rb^Gvs      , Rb^Gvs      , Rb^Gvs      , Rb^Gvs      , Rp          , Rp          , Rb^Gvs      , Rb^Gvs      , Rb^Gvs      , Rb          , Gg          , Gg          , Gg          , Rb          , Rb          , Gg          , Gg          , Gg          , Gg          , Gg          , Gg          , Gg          , Gg          , Gg          , Ss          , Ss          , Ss          , Gg          , Gg          , Gg          , Gg          , Hh          , Mm          , Mm          , Mm^Xm       , Mm          , Mm^Xm       , Mm^Xm       , Mm^Xm       , Mm          , Mm          , Hh          
Rb^Gvs      , Rb^Gvs      , Rb^Gvs      , Rb^Gvs      , Rb^Gvs      , Rb^Gvs      , Rp          , Rp          , Rb^Gvs      , Rb^Gvs      , Re          , Rb^Gvs      , Rb^Gvs      , Rb          , Gg          , Gg          , Gg          , Gg          , Gg          , Rb          , Rb          , Rb          , Rb          , Rb          , Rb          , Gg          , Gg          , Gg          , Gg          , Gg          , Gg          , Gg          , Gg          , Gg          , Gg          , Hh          , Mm          , Mm^Xm       , Mm          , Mm          , Mm^Xm       , Wo          , Wo          , Mm^Xm       , Mm          , Hh          
Rb^Gvs      , Rb^Gvs      , Rb^Gvs      , Rb^Vc       , Rp          , Rp          , Rb^Gvs      , Rb^Gvs      , Rb^Gvs      , Rb^Gvs      , Rb^Gvs      , Rb^Gvs      , Rb^Gvs      , Rb          , Gg          , Gg          , Gg          , Gg          , Gg          , Gg          , Gg          , Gg          , Gg          , Gg          , Gg          , Rb          , Rb          , Gg          , Gg          , Gg          , Gg          , Gg          , Gg          , Gg^Es       , Gg          , Hh          , Hh          , Mm          , Hh          , Mm          , Mm          , Mm^Xm       , Mm^Xm       , Mm^Xm       , Mm^Xm       , Mm^Xm       
Rb^Gvs      , Rb^Gvs      , Rp          , Rp          , Rb^Gvs      , Rb^Gvs      , Rb^Gvs      , Rb^Gvs      , Rb^Gvs      , Rb^Gvs      , Rb^Gvs      , Rb^Gvs      , Rb^Gvs      , Rb          , Gg          , Gg          , Gg          , Gg          , Ss          , Gg          , Gg          , Gg          , Ss          , Gg          , Ss          , Gg          , Gg          , Rb          , Rb          , Rb          , Rb          , Gg          , Gg          , Gg          , Gg          , Gg          , Hh          , Hh          , Mm          , Mm          , Hh^Fms      , Mm          , Mm          , Mm^Xm       , Ms^Xm       , Mm          
Rp          , Rp          , Rb^Vh       , Rb^Gvs      , Rb^Gvs      , Rb^Gvs      , Rb^Gvs      , Rb^Gvs      , Rb^Gvs      , Rb^Gvs      , Rb^Gvs      , Rb^Gvs      , Rb          , Rb          , Gg          , Gg          , Gg          , Gg          , Ss          , Ss          , Ss          , Ss          , Ss          , Ss          , Ss          , Gg          , Gg          , Gg          , Ss          , Gg          , Gg          , Rb          , Rb          , Gg          , Gg          , Gs^Fms      , Hh          , Hh          , Mm          , Mm          , Hh^Fms      , Gg          , Mm          , Mm^Xm       , Mm^Xm       , Mm^Xm       
Ww          , Ww          , Rb^Gvs      , Rb^Gvs      , Rb^Gvs      , Rb^Gvs      , Rb^Gvs      , Rb          , Rb^Gvs      , Rb^Gvs      , Rb^Gvs      , Rb          , Gg^Vc       , Gg          , Gg          , Ss          , Ss          , Gg          , Ss          , Ww          , Ss          , Ww          , Wo          , Ss^Vhs      , Ww          , Gg          , Wo          , Gg          , Ww          , Ss          , Gg          , Gg          , Ss          , Rb          , Rb          , Hh          , Hh          , Hh          , Hh          , Hh          , Hh          , Hh          , Gg          , Hh          , Mm          , Hh          
Rb^Gvs      , Ww          , Rb^Gvs      , Rb^Gvs      , Rb^Gvs      , Rb^Gvs      , Rb^Gvs      , Rb^Gvs      , Rb^Gvs      , Rb^Gvs      , Rb^Gvs      , Rb          , Gg          , Rb^Emf      , Ss          , Ss          , Ww          , Ss          , Ss          , Ss          , Gg          , Wo          , Hh          , Wo          , Gg          , Ww          , Ss          , Wo          , Ww          , Ww          , Wo          , Wo          , Wo          , Ss          , Gg          , Rb          , Hh          , Hh          , Gg          , Hh          , Mm          , Hh          , Gg          , Hh          , Ss          , Ww          
Rb^Gvs      , Rb^Gvs      , Rb^Gvs      , Rb^Gvs      , Rb^Gvs      , Rb^Gvs      , Rb^Gvs      , Rb^Gvs      , Rb^Gvs      , Rb^Gvs      , Rb          , Rb          , Gg          , Ss          , Ss          , Ss          , Ww          , Ss          , Ss          , Ss          , Ww          , Wo          , Ww          , Ss          , Ss          , Gg          , Gg          , Ww          , Gg          , Ss          , Ss          , Ss          , Ww          , Wo          , Wo          , Rb          , Rb          , Hh          , Ss          , Hh          , Hh          , Ss          , Ww          , Hh          , Ww          , Ww          
Rb^Gvs      , Rb^Gvs      , Rb^Gvs      , Rb^Fet      , Rb^Gvs      , Rb^Gvs      , Rb^Gvs      , Rb^Gvs      , Rb          , Rb          , Gg          , Ss          , Ss          , Gg          , Ss          , Ss          , Ss          , Ss          , Ww          , Wo          , Ww          , Ww          , Gg          , Ww          , Gg          , Ss          , Ss          , Ww          , Ss          , Ss          , Ss          , Sm          , Ss          , Wo          , Wo          , Ss          , Rb          , Hh          , Ss          , Gg          , Ww          , Ww          , Ss          , Ww          , Ss          , Ss          
Rb^Gvs      , Rb^Gvs      , Rb^Gvs      , Rb^Gvs      , Rb^Gvs      , Rb^Gvs      , Rb          , Rb          , Gg          , Gg          , Gg          , Ss          , Gg          , Ss          , Ss          , Ss          , Gg          , Wo          , Ss          , Gg          , Ss          , Sm          , Ss          , Gg          , Ss          , Gg          , Ss          , Ww          , Wo          , Gg^Efm      , Gg          , Ss          , Ss          , Ss          , Gg          , Wo          , Wo          , Rb          , Ss          , Ss          , Ww          , Ss          , Gg          , Sm          , Ss          , Ss          
Re          , Rb^Gvs      , Rb^Gvs      , Rb^Gvs      , Rb          , Rb          , Gg          , Gg          , Ss          , Ss          , Ss          , Wo          , Ss          , Ss          , Ss          , Gg          , Wo          , Wo          , Ds          , Ss          , Ss          , Ss          , Gg^Efm      , Ss          , Sm          , Ww          , Ss          , Wo          , Ww^Ewl      , Ss          , Ss          , Ss          , Ss          , Ss          , Ss          , Gg          , Gg          , Wwg         , Wo          , Wo          , Gg          , Ss^Vhs      , Gg          , Ss          , Gg          , Gg          
Rb^Gvs      , Rb^Gvs      , Rb^Gvs      , Rb^Gvs      , Rb          , Gg          , Gg          , Ss          , Gg          , Gg          , Gg          , Gg          , Wo          , Ss          , Gg          , Wo          , Ww          , Ww          , Gg          , Ss          , Gg          , Ww          , Ss          , Ss          , Ss          , Ss          , Ss          , Ss          , Ss          , Ss          , Ss          , Gg          , Gg          , Gg          , Gg          , Ss          , Gg          , Rb          , Rb          , Gg          , Gg          , Gg          , Gg          , Gg          , Gg          , Gg          
