border_size=1
usage=map

Gg, Gg, Gg, Mm^Xm, Mm, Hh, Gg, Gs, Hh, Gs, Gg, Gs, Hh, Gs, Re, Re, Rb, Rb, Gs, Gg, Gg, Gg, Gg, Gg, Gg, Gg, Ww, Wo, Gg, Gg, Gg, Hh, Mm, Mm, Mm, Mm^Xm, Gg, Wo, Wo, Wo, Rb, Hh, Ww, Mm, Mm, Mm, Mm, Wo, Hh^Fms, Mm, Mm, Gs^Fds, Gg, Gs^Fds, Gg
Gg, Gg, Gg, Mm, Mm, Gs, Gg, Gs, Gs, Gg, Gs, Gs, Re, Re, Hh, Hh, Mm^Xm, Gg, Gg, Gg, Gs, Gg, Ww, Gg, Ww, Ww, Ww, Wo, Ss, Gg, Hh, Hh, Mm, Mm, Mm^Xm, Mm^Xm, Mm, Gg, Gg, Wo, Wo^Bw|r, Wo, Ww, Hh, Wwf, Mm, Mm, Mm^Xm, Hh^Fms, Hh^Fms, Wo, Gs^Fds, Gs^Fds, Gs^Fds, Ww
Gg, Gg, Gg, Mm, Gs, Gg, Gs, Hh, Gg, Gs, Gg, Rb, Gg, Gs, Hh^Vhh, Mm^Xm, Mm, Hh, Hh, Gg, Ww, Ww, Gg, Wo, Sm, Ss, Ww, Wo, Gg^Efm, Hh, Mm, Mm, Mm, Mm, Mm^Xm, Hh, Hhd, Mm, Mm, Hh, Rb, Wo, Ww, Wo, Hh, Mm, Mm, Mm^Xm, Mm^Xm, Wo, Wo, Wo, Wo, Ww, Wo
Gg, Gg, Gg, Gs, Gs^Es, Gg, Gs, Gs, Gg, Gs, Gs, Re, Gs, Gg, Mm^Xm, Mm^Xm, Mm^Xm, Mm, Mm, Mm, Ww, Gg, Ss, Ss, Gg^Efm, Ss, Gg^Efm, Ww, Ww, Hh, Mm, Mm, Mm^Xm, Mm, Gd, Mm, Hh, Hh, Mm, Gg, Rb, Wo, Wo, Wo, Mm, Mm, Wo, Wo, Mm^Xm, Wo, Hh, Ww, Gg, Wo, Gg
Gg, Gg, Gg, Mm, Mm, Hh, Gs, Gs, Gg, Hh, Gs, Re, Gg, Hh, Mm^Xm, Mm, Mm, Ms^Xm, Ms^Xm, Ww, Ms, Hh, Ss, Ss, Gg, Ss, Hh, Ss, Ww, Ms, Ms^Xm, Ms^Xm, Mm^Xm, Mm^Xm, Mm, Mm, Mm, Mm, Hh, Mm, Re, Mm, Wo, Wo, Wo, Ww, Wo, Wo, Mm^Xm, Hh, Hh, Hh^Vhh, Gg, Gg, Gg
Gg, Gg, Gg, Hh, Gg, Gs, Gg, Gs, Gs, Gs, Rb, Rb, Gg, Hh, Mm, Mm, Mm, Ms^Xm, Ms^Xm, Mm^Xm, Ms, Hh, Gg, Hh, Hh, Hh, Mm, Hh, Mm^Xm, Mm^Xm, Mm, Mm, Mm, Mm, Hh, Mm, Mm, Mm, Mm, Gs, Re, Hh, Hh, Wo, Mm, Wo, Mm, Mm, Mm^Xm, Ch, Rb, Gg, Rb, Gg, Re
Gg, Gg, Gg, Hh^Fp, Hh, Gs, Gs, Gg, Gs, Gg, Rb, Gs, Gg, Gg, Mm, Mm, Mm, Mm, Gg^Efm, Mm^Xm, Mm^Xm, Mm, Mm, Hh, Gg, Mm, Mm^Xm, Mm^Xm, Mm, Mm, Hh, Mm, Mm, Mm, Gd, Mm, Hhd, Mm, Mm, Mm, Re, Mm^Xm, Mm^Xm, Hh, Gg, Mm, Gs, Hh, Mm^Xm, Rb, Gs, Rb, Gg, Re, Gs
Gg, Gg, Gg, Mm, Mm, Hh, Gg, Gg^Es, Gs, Rb, Gs, Gs, Gs, Hh, Mm, Mm, Mm, Mm, Mm, Mm, Mm, Mm^Xm, Mm, Mm, Mm, Mm^Xm, Mm, Mm, Hh, Hh, Mm, Mm, Hh, Mm, Gs, Hhd, Re, Hhd^Vhhr, Gs, Mm, Re, Hh, Mm, Mm, Hh, Gs, Mm^Xm, Mm^Xm, Mm^Xm, Ch, Gg, Gs, Hh, Gs, Ch
Gg, Gg, Gg, Mm, Mm, Hh, Gg, Ce, Ce, Rb, Gg, Hh, Hh^Vhh, Mm, Gg, Mm, Mm, Mm, Gg^Efm, Mm, Mm, Wo, Mm^Xm, Mm, Mm^Xm, Ms^Xm, Hh, Mm, Hh, Mm, Hh, Hh, Gd, Hh, Mm, Gd, Gs, Mm, Mm, Mm, Re, Hh, Gs, Hh, Hh, Mm^Xm, Mm^Xm, Mm, Mm^Xm, Hh, Mm, Hh^Vhh, Mm, Ch, Kh
Mm, Mm^Xm, Mm^Xm, Mm^Xm, Mm, Hh, Hh, Ke, Ce, Re, Hh, Mm, Mm, Mm, Mm, Gg^Efm, Gg, Mm, Mm, Mm, Mm, Mm, Mm^Xm, Mm^Xm, Hh^Vhh, Hh, Gd, Gd, Hh, Hhd, Hh, Hhd, Gs, Wwf, Gs^Vh, Gd, Gs, Gs, Rd, Re, Gs, Mm, Mm, Mm, Mm^Xm, Mm, Mm, Mm, Mm^Xm, Mm^Xm, Mm^Xm, Mm, Mm, Hh, Gg
Mm, Ms^Xm, Mm, Mm, Hh, Mm, Hh, Hh, Hh, Re, Hh, Mm, Hh, Mm, Hh, Mm, Mm, Mm, Mm, Mm, Gg^Efm, Mm^Xm, Ms^Xm, Wo, Mm, Gs, Gs, Hh, Gs, Gd, Gd, Hh, Mm, Re^Gvs, Gs, Gs, Re, Re, Hh, Gs, Gs, Hh, Mm, Mm, Mm^Xm, Ms, Mm, Mm, Mm^Xm, Wo, Wo, Mm^Xm, Mm, Hh, Mm^Xm
Mm^Xm, Ms^Xm, Mm, Mm, Hh, Mm, Hh, Gg, Re, Re, Gs, Hh, Mm, Mm, Mm, Gg^Es, Mm, Mm, Mm, Hh, Mm, Ms^Xm, Mm, Mm, Mm, Hh, Hh, Gd, Hhd, Gs, Gd, Gs, Gs, Gs, Gs, Gs, Re, Hhd, Mm, Gs, Gs, Hh, Ms, Ms, Mm^Xm, Ms^Xm, Ms^Xm, Ms^Xm, Mm, Mm^Xm, Mm^Xm, Mm^Xm, Mm^Xm, Mm^Xm, Mm^Xm
Mm^Xm, Mm, Hh, Mm, Hh, Mm, Mm, Hh, Rb, Gg, Mm, Mm, Mm, Mm, Mm^Xm, Mm, Ms^Xm, Mm, Mm^Xm, Mm, Ms^Xm, Mm^Xm, Mm, Mm, Mm, Gs, Hh, Hhd, Hh, Gs, Gs, Hh, Gs, Gs, Gs, Gs, Re, Gs, Gs, Hh, Mm, Mm, Mm^Xm, Mm^Xm, Ms, Ms, Hh, Mm, Hh^Fms, Mm, Mm, Mm^Xm, Ms^Xm, Mm, Mm^Xm
Mm, Hh, Hh^Vhh, Mm, Hh, Hh, Hh, Rb, Mm, Gg, Mm, Mm, Mm^Xm, Mm^Xm, Gg, Ms^Xm, Mm, Mm^Xm, Mm, Mm^Xm, Hh, Mm, Hh, Gs, Hh, Gs, Gs, Hh, Gs, Gd, Gs, Gd, Gs, Gd, Gs, Re, Hh, Hh, Gd^Vhr, Mm, Mm, Mm^Xm, Ms, Ms, Ms, Ms, Mm^Xm, Mm, Hh^Fms, Gs^Es, Gs, Mm^Xm, Mm^Xm, Mm^Xm, Ww
Gg, Hh, Gg^Efm, Gg, Gg, Gg, Gg, Rb, Gg, Mm, Mm, Mm, Mm^Xm, Hh, Mm, Mm, Mm, Mm, Mm, Mm, Hh, Hh, Hh, Hh, Hh, Hh, Gs, Gs, Hh, Gs, Gd, Gd, Gs, Gs, Re, Re, Gd, Rd, Hh, Mm, Mm^Xm, Mm^Xm, Ms, Ww, Hh, Hh, Gg, Hh, Hh, Hh, Gg, Hh, Mm, Hh, Ww
Hh, Hh, Gg, Gg, Mm, Gg^Efm, Gg, Re, Gs, Mm, Gg, Gs, Mm^Xm, Mm, Mm, Mm, Mm, Hh, Hh, Mm, Hh, Gg, Hh, Gs, Hh, Hh, Hh, Gs, Gs, Gs, Gs, Gd, Gs, Re, Hh, Gs, Hh, Hh, Mm, Mm^Xm, Mm, Ms, Ww, Wo, Mm, Gg, Gs, Hh, Mm, Hh, Gg, Hh, Ss, Ww, Gg
Mm, Hh, Hh, Mm, Hh, Gg, Gs, Re, Gg, Gg, Mm^Xm, Mm^Xm, Mm, Hh, Mm, Mm, Mm, Gg, Mm, Hh, Mm, Gs, Hh, Hh, Hh, Hh, Hh, Hh, Hh, Mm, Gs, Gs, Re, Re, Gs, Hh, Mm, Mm, Mm, Mm^Xm, Hh, Mm, Wo, Hh, Mm, Mm, Gg, Hh, Hh, Ss, Wwf, Gg, Ww, Ww, Rb
Gg, Mm, Mm^Xm, Mm, Mm^Xm, Mm, Mm, Rb, Mm, Mm^Xm, Hh, Mm, Mm, Mm, Hh, Gg, Mm, Mm, Hh, Mm, Mm, Mm, Mm, Hh, Gs, Hh, Gs, Gs, Re, Gs, Re, Re, Re, Gs, Gs, Gs, Mm, Mm, Mm, Mm^Xm, Mm^Xm, Mm, Mm, Wo, Ww, Gg^Efm, Gg, Gg, Ww, Ww, Gg, Wo, Sm, Sm, Ss
Mm^Xm, Mm, Mm^Xm, Mm^Xm, Hh, Mm, Gg, Rb, Mm, Mm, Mm, Hh, Hh, Gg^Efm, Mm, Hh, Hh, Hh, Hh, Mm, Hh, Mm, Hh, Gg, Re, Re, Re, Re, Gs, Re, Ce, Ce, Ke, Hh, Hh, Hh, Mm, Mm, Mm, Mm, Mm^Xm, Mm, Mm, Hh, Hh, Wwf, Ww, Ss, Ww, Gg, Rb, Rb, Ss, Ss, Ss
Mm^Xm, Mm^Xm, Mm, Mm, Mm, Mm, Mm, Rb, Mm, Mm, Gg, Hh, Mm, Gs, Mm, Hh, Mm, Hh, Re, Hh, Re, Re, Re, Re, Hh, Gs, Gg, Gs, Gs, Re, Mm, Ce, Hh, Gg, Hh, Gg, Mm, Mm, Mm, Mm^Xm, Hh, Hh^Fp, Mm, Mm, Gg, Gg, Ww, Gg, Ww, Ss^Vhs, Rb, Ss, Ss, Gg, Gg^Efm
Mm, Mm, Mm, Mm, Mm, Mm, Mm, Re, Mm, Hh, Mm, Mm, Gs, Mm, Re, Hh^Vhh, Re, Re, Gs, Re, Hh, Gs, Gs, Gs, Gs, Gs, Hh, Hh, Re, Re, Hh, Mm, Mm, Hh, Gg, Hh, Hh, Mm, Mm, Mm^Xm, Hh, Hh^Fp, Gg^Efm, Gg^Es, Mm, Hh, Wo, Wo, Sm, Gg, Rb, Gg, Gg, Ss, Ss
Gg, Hh, Hh, Hh, Mm, Hh, Gg, Re, Re, Mm, Re, Gs, Re, Re, Mm, Re, Gs, Hh, Gg, Gs, Gs, Gg, Gs, Gg, Gs, Gg, Hh, Re, Gs, Mm, Hh, Gg, Hh, Hh, Mm, Hh, Hh, Mm, Mm^Xm, Mm^Xm, Hh, Mm, Mm, Mm, Mm, Gg, Ww, Ss, Sm, Ss, Rb, Ss, Gg^Em, Ss, Ss
Mm, Mm, Gg^Es, Hh, Mm, Mm, Hh, Re, Gg, Re, Mm, Re, Ke, Ce, Ce, Gs, Gg, Gs, Gs, Gs, Gg, Hh, Gs, Gs, Gs, Gs, Gs, Re, Mm, Hh^Vhh, Gg, Gs, Hh, Gg, Mm, Gg, Hh, Mm, Mm^Xm, Mm, Hh, Mm, Rb^Gvs, Rb^Gvs, Gs^Vc, Ww, Wo, Ss, Gg, Ss, Rb, Ss, Ss, Sm, Gg
Mm, Mm, Hh, Mm, Gg, Hh, Gg, Rb, Re, Mm, Mm, Hh, Gg, Ce, Gs, Gg, Gs, Gg, Hh, Gg, Gs, Hh, Gs, Gg, Gs, Gs, Re, Re, Mm, Hh, Mm, Gg, Hh, Mm, Mm, Mm, Mm, Mm, Mm^Xm, Mm, Mm, Gg, Gg^Em, Rb^Gvs, Rb, Wo, Wo, Gg, Ww, Rb, Gg, Gs^Vc, Gg, Hh, Ww
Hh, Mm, Mm, Mm, Hh, Hh, Hh, Gg, Re, Mm, Mm, Gg, Gg, Gs, Hh, Hh, Gg, Hh, Gg, Gg, Gg, Hh, Hh, Gg, Rb, Re, Mm, Mm, Hh, Hh, Gg, Gg, Mm, Gg, Mm, Mm, Mm, Mm, Mm^Xm, Mm, Mm, Gg, Gg^Efm, Rb, Ss, Ww, Ww, Wo, Ww, Ww^Bw|r, Ww, Ww, Wo, Wwf, Gg
Hh, Mm, Mm, Mm, Gg, Hh, Hh, Gs, Gs, Re, Re, Mm, Gg, Gs, Gs, Gg, Hh, Gs, Gg, Hh, Gs, Gs, Gs, Gg, Re, Hh, Gs, Hh, Hh, Hh, Hh, Gg, Mm, Gg, Mm, Gg^Efm, Mm, Mm^Xm, Mm, Mm, Mm, Ss, Ss, Rb, Wwf, Ww, Wo, Wo, Ss, Wwf, Ww, Ww, Ww, Md, Gg
Gg, Hh, Mm, Mm, Mm, Gg, Hh, Gs, Hh, Gg, Hh, Re, Rb, Hh, Mm, Hh, Gs, Hh, Hh, Gg, Gs, Gg, Hh, Rb, Hh, Gg, Hh, Gg, Hh, Mm, Hh, Gg, Mm, Mm, Mm, Mm, Ms, Ms^Xm, Mm^Xm, Mm, Mm, Gg, Ss, Ww, Ss, Gg, Wo, Ss, Gg, Ww^Bw|r, Ww, Gg, Ww, Ww, Gg
Gg^Efm, Hh, Mm, Hh, Gg, Mm, Mm, Gs, Gg, Hh, Hh, Gg, Gg, Rb, Rb, Gg, Gg, Gg^Efm, Hh, Gg, Gs, Gg, Rb, Rb, Hh, Gg^Es, Hh, Mm, Gg, Gg, Hh, Mm, Mm, Mm, Mm, Mm, Mm^Xm, Ms^Xm, Mm, Mm, Mm, Ss, Ss, Ww, Wo, Wo^Bw|r, Ww, Gg, Gg, Rb, Ss, Ww, Ww, Ww, Rb
Ww, Gg^Efm, Hh, Mm, Mm, Mm, Gg, Hh, Mm, Gg, Hh, Gg, Hh, Hh, Gg, Re, Re, Gg, Gg, Hh, Gs^Vh, Gg, Rb, Hh, Gg, Gg, Mm, Gg, Mm, Mm, Mm, Mm, Mm^Xm, Mm^Xm, Wo, Mm, Mm^Xm, Mm, Ww, Mm, Mm, Mm, Ww, Ww, Wo, Wwf, Gg, Ss, Gg, Rb, Chs, Ww, Wwf, Ww^Bw/r, Wwf
Gg, Wo, Ww, Wo, Wo, Mm, Mm, Mm, Mm, Mm, Gg, Hh, Gg, Gg^Es, Hh, Hh, Gs, Rb, Re, Hh, Hh, Rb, Gg, Gg, Mm, Gg, Mm, Gg, Gg, Mm, Ms^Xm, Ms^Xm, Mm, Ww, Ww, Wo, Wo, Wo, Wo, Wo, Wo, Wo, Ww, Wo, Ww, Ss, Gg, Ss, Ss, Rb, Rb, Rb, Gg, Ww, Ww
Mm, Mm, Mm, Gg^Efm, Ms, Ww, Ww, Mm, Mm, Mm, Mm, Mm, Mm, Mm, Mm, Gg, Mm, Gg, Gs, Re, Rb, Rb, Hh, Hh, Hh, Mm, Mm^Xm, Mm^Xm, Ms^Xm, Hh, Rb, Mm, Gg^Emf, Wo, Mm, Ww, Ww, Wo, Wo, Wo, Ww, Ww, Gg, Gg, Ss^Vhs, Gg, Gg, Gg, Rb, Rb, Gg, Gg, Gg, Gg, Ww
Mm, Mm, Mm, Mm, Mm, Ms, Ms, Ms, Hh, Mm, Mm, Mm, Mm, Mm, Mm, Mm, Mm, Mm, Mm, Gg, Re, Gg, Hh, Hh, Hh, Mm, Mm^Xm, Mm, Mm, Mm, Ww, Gs^Vc, Ww, Ww, Wo, Wo, Wo, Wo, Ww, Ww, Ww, Ss, Gg, Ss, Ss, Sm, Gg, Re, Re, Gg, Ss, Gg, Ss, Gs^Vc, Ww
Mm, Mm, Mm, Mm, Hh, Ms, Ms^Xm, Hh, Mm^Xm, Mm^Xm, Mm^Xm, Mm^Xm, Mm^Xm, Hh, Mm^Xm, Mm^Xm, Mm^Xm, Mm^Xm, Mm, Hh, Re, Gs, Mm, Mm, Mm, Mm, Wo, Ww, Ww, Ww, Wo, Ww, Wo, Wo, Ww, Wo, Wo, Ww, Gg, Ww, Gg, Gg, Ss, Gg^Efm, Ss, Ss, Gg, Rb, Gg, Gg, Gg, Gg, Gg, Gg, Gg
Mm^Xm, Mm, Mm, Hh, Mm^Xm, Ms^Xm, Wo, Mm^Xm, Mm, Mm, Mm, Mm, Mm, Mm^Xm, Mm, Mm, Mm, Mm, Hh, Hh, Rb, Gg, Mm, Mm, Mm, Mm, Wo, Ww, Wo, Wo, Wo, Wo, Wo, Wo, Wo, Wo, Ww, Wo, Gs^Vc, Gg, Gg, Gg, Gg, Gg, Gg, Ss, Rb, Rb, Ss, Ss, Wo, Wo, Ww, Ss, Gg
Mm, Mm^Xm, Mm^Xm, Mm^Xm, Mm, Mm, Mm, Mm, Mm, Mm, Mm, Mm, Mm, Mm, Mm, Mm, Mm, Mm, Mm, Gg, Re, Gs, Mm, Mm, Mm, Wo, Wo, Ww, Wo, Wo, Wo, Wo, Ww, Wo, Wo, Ww, Wo, Wo, Rb, Ss, Rb^Gvs, Ss, Gg, Ss, Rb, Rb, Gs^Vc, Gg, Gg^Em, Ss, Ss, Ww, Ss, Rb, Gg
