border_size=1
usage=map

Ww, Wo, Wo, Ww, Ww, Ww, Wo, Wo, Ww, Wo, Wo, Wo, Wo, Wo, Ww, Wo, Wo, Wo, Ww, Gg, Gg, Gg, Gg, Re, Re, Re
Wo, Ww, Wo, Ww, Wo, Wo, Wo, Ww, Wo, Wo, Wo, Ww, Wo, Wo, Wo, Wo, Wo, Wo, Wo, Ww, Ww, Gg, Wwf, Gs, Gg, Gs^Vc
Wo, Wo, Ww, Wo, Ww, Ww, Wo, Wo, Wo, Wo, Wo, Wo, Wo, Wo, Wo, Wo, Wo, Wo, Wo, Ww, Ww, Wo, Gg, Gg, Gg, Gg
Wo, Wo, Wo, Ww, Wo, Wo, Wo, Wo, Wo, Wo, Ww, Wo, Ww, Wo, Wo, Wo, Wo, Wo, Wo, Ww, Wo, Ww, Ww, Wo, Gg, Gg
Wo, Wo, Wo, Wo, Ww, Wo, Wo, Wo, Wo, Wo, Wo, Wo, Ss, Ww, Wo, Ww, Ww, Wo, Ww, Wo, Wo, Ww, Wwf, Wwf, Wwf, Gg
Wo, Wo^Bw\r, Gg, Gs^Vc, Gg, Gg, Wo, Wo, Wo, Ww, Ss, Wo, Wo, Gg, Wo, Wo, Ww, Wo, Wo, Wo, Ww, Ww, Ww, Ww, Wwf, Gg
Wo, Wo, Gg, Gg, Gg, Wo, Ww, Wo, Wo, Wo, Ww, Gg, Wo, Gg, Wo, Ww, Wo, Wo, Ww^Vm, Wo, Ww, Ww, Ww, Wwf, Gg, Gg
Wo, Wo, Wo, Wo, Wo, Wwf, Wo, Ww, Gg, Gg, Gg, Gg, Ww, Ww, Gg, Wo, Ww, Wwf, Wo, Wwf, Wo, Ww, Wo, Wo, Ww, Gg
Wo, Wo, Wo, Wo, Wo, Ww, Gg, Gg, Gg, Ss, Ss, Ss, Ss, Gg, Ww, Ss, Wo, Gg, Ww, Wwf, Wo, Ww, Ww, Wo, Wo, Wo
Wo, Wo, Wo, Wo, Ww, Wo, Ww, Gg, Ss, Ss, Gg, Ww, Ss, Gg, Ss, Ss, Ww, Gg, Hh, Ww, Ww, Wwf, Ww, Wo, Wo, Wo
Wo, Wo, Wo, Wo, Wo, Ww, Wo, Ww, Wo, Wo, Ww, Gg, Gg, Gg, Ss, Gg, Gg, Hh, Ss, Ww, Ss, Ss^Vhs, Gg, Wo, Wo, Wo
Wo, Ww, Wo, Wo, Wo, Wo, Wo, Wo, Ww, Wo, Wo, Ww, Ww, Ss^Vhs, Gg, Ww, Ss, Ss, Ww, Ww, Ss, Hh, Mm^Xm, Wo, Wo, Wo
Wo, Ww, Ww, Wo, Wo, Ww, Ww, Ww, Ww, Wo, Wo, Wo, Ww, Ww, Gg, Ss, Ww, Wo, Hh, Gg, Mm, Hh, Mm, Mm^Xm, Mm^Xm, Hh
Wo, Wo, Ww, Wo, Wo, Wo, Wo, Wo, Ww, Wo, Wwf, Wo, Ww, Gg, Ww, Gg, Ww, Ww, Gs^Vc, Mm, Hh, Hh, Hh, Mm, Ms^Xm, Hh
Wo, Wo, Ww, Wo, Wo, Wo, Wo, Wo, Wo^Bw\r, Wo, Gg, Ww, Gg, Ss, Wwf, Gg, Ss, Ww, Wo, Gg, Ss, Hh, Hh^Vhh, Ms, Mm^Xm, Mm
Ww, Wo, Wo, Wo, Wo, Wo, Ww, Wo, Ww, Gg, Gs^Vc, Ww, Gg, Ww, Gg, Ww, Gg, Gg, Ss, Wo, Ww, Wo, Ww, Wo, Mm, Mm^Xm
Gg, Wo, Wo, Wo, Ww, Wo, Wo, Ww, Gg, Gg, Gg, Gg, Gg, Wwf, Ww, Gg, Gg, Gg, Gg, Wo, Ww, Ss, Hh, Hh, Mm, Mm
Wo, Ww, Wo, Ww, Wo, Ww, Ww, Gg, Gg, Gg, Gg, Gg, Gg, Gg, Gg, Gg, Gg, Gg, Ss, Ww, Ww, Ss, Mm, Hh, Mm^Xm, Mm^Xm
Wo, Ww, Ww, Wo, Ww, Wo, Ww, Gg, Gg, Gg, Gs, Gg, Gg, Gg, Gg, Gg, Hh, Gg, Hh, Hh, Ww, Gg, Hh, Hh^Vhh, Mm^Xm, Mm
Wo, Wo, Wo, Gg, Gg, Wo, Gg, Gg, Ce, Gg, Gs, Gg, Gs, Gg, Gg, Gg, Mm, Mm, Mm, Mm, Wo, Hh, Mm, Mm^Xm, Mm, Mm^Xm
Ww, Ww, Ww, Gs^Vc, Gg, Gg, Gg, Ce, Ke, Ce, Gg, Gg, Gg, Gg, Hh, Gg, Gg, Mm^Xm, Mm^Xm, Mm^Xm, Ms^Xm, Wo, Hh, Mm^Xm, Wo, Ms^Xm
Wo, Ww, Ww, Ww, Gs, Gg, Gs, Gg, Gg, Ce, Gs, Gs, Gg, Gg, Gs, Hh, Hh, Gg, Hh, Hh, Ha^Vhha, Ww, Wo, Wo, Ms, Ha
Ww, Wo, Gs, Gg, Gg, Gs, Gs, Gg, Gg, Gg, Gg, Gs, Mm, Hh, Mm, Mm, Mm^Xm, Mm, Hh, Mm, Hh, Mm^Xm, Mm, Wo, Wo, Wo
Gg, Gs, Gs, Gs, Gs, Gg, Gs, Gs, Hh, Hh, Gs, Mm, Hh, Mm, Mm, Mm, Mm^Xm, Mm^Xm, Mm^Xm, Mm^Xm, Hh, Mm, Mm^Xm, Mm^Xm, Ww, Mm^Xm
Gg, Gs, Gg, Gs, Gg, Gg, Gs, Gs, Hh, Hh, Hh, Mm, Hh, Mm, Hh, Hh^Vhh, Mm^Xm, Mm, Hh, Hh, Gg, Gs, Hh, Mm^Xm, Mm^Xm, Mm^Xm
Gg, Gg, Gs, Gg, Gs, Gs, Hh, Hh, Hh, Mm, Mm, Mm, Gg, Hh, Gg, Gs, Mm, Hh, Mm, Mm, Gs, Gs, Hh, Mm^Xm, Mm^Xm, Mm
