border_size=1
usage=map

Hh, Hh, Mm^Xm, Mm^Xm, Md, Md, Mm^Xm, Mm, Hhd, Gd, Hhd, Gd, Hhd, Mm, Gd, Gd, Dd, Gd, Rp, Rp, Gd^Dr, Dd, Hd, Gd, Dd, Gd, Dd, Hhd, Mm^Xm, Mm^Xm, Hhd, Gg, Md, Mm
Mm, Mm^Xm, Mm^Xm, Mm^Xm, Mm, Md, Mm^Xm, Hhd, Hhd, Gd, Gd, Gd^Edb, Gd, Gd, Gd, Hhd, Gd, Gd, Rd, Gd, Gd, Gd^Esd, Gd, Hhd, Dd, Hd, Hhd, Rd, Md, Mm^Xm, Md, Md, Md, Md
Mm, Mm, Mm, Mm^Xm, Mm^Xm, Mm, Md, Mm^Xm, Mm, Gd, Hhd, Gd, Mm, Hhd, Hhd, Gd, Gd^Dr, Gd, Rd^Esd, Dd, Gd, Dd, Hhd, Gd, Rd, Gd^Esd, Rd, Hhd, Hh, Mm^Xm, Mm^Xm, Hh^Vhh, Hhd, Md^Xm
Mm, Mm, Mm^Xm, Mm, Mm, Mm, Mm, Mm^Xm, Mm^Xm, Mm, Mm, Gd, Gd, Gd, Gd, Gd, Gd, Gd, Rd, Rd, Gd, Rd, Rd, Gd, Gd, Gd, Rd, Gs, Mm, Mm, Mm, Wo, Wo, Hhd
Mm, Ms^Xm, Mm, Mm^Xm, Qxu, Mm^Xm, Mm^Xm, Qxu, Mm, Mm, Mm, Hhd, Hhd, Gd, Hhd, Rd, Rd, Gd^Es, Rp, Gd, Gd, Gd^Dr, Rd, Rd, Hhd, Rd, Rd^Gvs, Hh^Vhh, Wwg, Md^Xm, Ms^Xm, Md^Xm, Mm, Mm
Mm, Mm, Mm, Mm, Mm^Xm, Mm, Mm, Mm^Xm, Mm, Mm, Hhd, Gd, Hhd, Hhd, Gd, Gd, Gd, Gd, Hhd, Rp, Gd, Rd, Gd, Gd, Gd, Rd, Re, Rb^Gvs, Mm, Hh, Mm, Md^Xm, Mm^Xm, Mm
Ww, Wo, Mm, Mm, Ms^Xm, Ms^Xm, Mm, Mm, Mm, Mm, Hhd, Gd^Dr, Gd, Gd^Vhr, Rd, Gd^Dr, Hhd, Gd, Gd, Rd, Gd, Hhd, Gd, Md, Hhd, Hhd, Gd, Md, Hh, Mm, Mm, Md^Xm, Mm, Mm^Xm
Mm, Mm, Mm^Xm, Qxu, Mm, Ms^Xm, Mm, Mm, Mm, Mm, Hhd, Gs, Hhd, Gd, Rd, Gd, Hhd, Hhd, Rd, Rp, Rd, Rd, Gs, Gs, Gd^Dr, Hhd, Mm, Mm, Md^Xm, Mm, Hh, Mm, Gg^Efm, Mm
Mm, Mm, Ms^Xm, Mm^Xm, Mm^Xm, Mm, Mm, Mm, Mm, Mm, Gd, Hhd, Gs, Gd^Es, Gd, Gd, Gd, Rd, Md, Rp, Md, Hhd, Md, Md, Gd, Mm, Md, Mm, Md, Mm, Mm, Mm, Mm, Mm
Mm, Mm, Mm^Xm, Ms^Xm, Mm^Xm, Mm, Mm, Mm, Hhd, Hhd^Vhhr, Gd, Hhd, Gd, Gs, Hhd, Hhd, Hhd, Hhd, Hhd, Rd, Rp, Hhd, Md, Md, Hh, Gs^Efm, Mm, Md, Hh, Mm, Mm, Mm, Mm, Md
Mm^Xm, Mm^Xm, Ms^Xm, Mm^Xm, Mm, Mm, Mm, Mm, Gd, Hhd, Hhd, Gd, Gd, Gs, Hhd, Hhd, Hhd, Rd, Rd, Gd, Gd^Vhr, Rd, Rp, Md, Rb^Gvs, Gs^Vh, Wwg, Md^Xm, Mm, Mm, Ms^Xm, Ms^Xm, Mm, Mm
Mm^Xm, Ms^Xm, Mm^Xm, Ms^Xm, Mm, Mm, Mm, Mm, Hhd, Hhd, Gs, Gd^Es, Gd, Gd, Hh, Gd^Es, Hhd, Rd^Es, Rd, Rd, Gd, Rd, Rd, Rp, Gs, Rb^Gvs, Mm, Hh, Mm^Xm, Hh, Hh, Mm, Ww, Mm
Mm, Mm^Xm, Mm, Mm, Mm, Mm, Hhd, Hhd, Hhd, Gd, Gd, Gd, Hhd, Hhd, Hhd, Gd, Hh, Gs, Rd, Rd, Rd, Rd, Rd, Rp, Rd, Mm, Ww, Gg, Ww, Wo, Wo, Ww, Mm, Ww
Mm, Mm, Hh, Mm, Hh, Mm, Gd, Hhd, Gd, Gs, Hh, Gd, Hhd, Hhd, Gd, Hhd, Hhd, Hhd, Hh, Gd, Gd, Gd^Es, Gs, Rp, Rp, Hh, Wo, Wo, Re, Re, Re, Re, Re, Hh
Mm, Hh, Mm, Hh, Hh, Gs, Gd, Gs, Gd^Es, Gd, Gs, Hh, Hhd, Gd, Gd, Gd, Rd, Gd, Gd, Gd, Gd, Rd, Gs, Gs, Wo^Bw|r, Wo, Re, Re, Mm, Mm, Mm, Hh, Hh, Re
Md, Hh, Mm, Hh, Hh, Hh, Gd, Gd, Gs, Gg, Hhd, Hhd^Vhhr, Rd, Rd, Gd^Dr, Gd, Hh, Gd, Gd, Hh, Gs, Gs, Wo, Wo, Rp, Chr, Hh, Mm, Mm, Mm, Mm, Ms^Xm, Mm, Hh
Re, Hh, Gs, Hh, Gs, Gs, Hh, Gs, Hh, Hh, Gs, Rd, Rd, Rd, Gd, Rd, Gd, Gs, Hh, Gs, Gs, Gs, Wo, Wo, Rp, Gg, Hh, Mm, Mm, Mm, Hh, Ms^Xm, Mm, Mm
Hh, Re, Re, Hh, Md, Hh, Hh, Gs, Gs, Gd, Gd, Rd, Gs, Rd, Gd, Gd, Hh, Gs, Hh, Gg, Wo, Hh, Wog, Hh^Vhh, Rp, Gg, Gg, Mm, Mm, Mm, Mm, Ms^Xm, Mm, Mm
Gs, Gs, Rd, Re, Re, Md, Re, Re, Re, Gs, Gs, Hh, Gs, Gs, Gs, Gs, Hh, Gs, Hh, Gg, Wo, Wog, Mm, Hh, Rp, Hh, Mm, Mm, Mm, Ms^Xm, Mm, Mm, Ms^Xm, Mm
Gs, Gs, Gs, Gs, Hh, Re, Gs, Gs, Gs, Re, Rb, Gs, Hh, Hh, Gs^Es, Gs, Re, Gs, Re, Hh, Ww, Mm, Mm, Mm, Rp, Mm, Mm, Mm, Ms^Xm, Ms^Xm, Wo, Mm, Mm, Mm
Gs, Gg, Gs, Gs, Gs, Gs^Es, Hh, Hh, Gs^Vc, Rd, Gg, Rb, Re, Gs, Re, Re, Gs, Re, Hh, Re, Ww, Hh, Hh, Gg, Rp, Mm, Mm, Mm, Mm, Wo, Gg^Efm, Ms^Xm, Mm, Mm
Gg, Gs, Gs, Gs, Hh, Gs, Gs, Gs, Ww, Gg, Gs^Vc, Gs, Gs, Re, Gs, Gs, Gs, Hh, Ww, Ww, Wo, Re, Re, Gs, Rp, Gs, Mm, Mm, Mm, Ms^Xm, Mm, Mm, Mm, Gg
Gg, Gs, Gs, Gs, Gs, Gs, Ww, Ww, Ww, Ww, Wo, Hh, Gs, Hh, Gg, Gg, Gg, Mm, Wo, Ww, Hh, Hh, Gs, Re, Rp, Hh, Mm, Mm, Ms^Xm, Ms^Xm, Mm, Mm, Ms^Xm, Mm
Gg, Gs, Hh, Gs, Hh, Gs^Vc, Wo, Wo, Wo, Wo, Wo, Gg, Gs, Gs, Gs, Gs, Gs, Wo, Ww, Hh, Wo, Gs^Vc, Hh, Gs, Rp, Mm, Hh, Mm, Mm, Mm, Mm, Hh, Hh, Mm
Gg, Rd, Gs, Gs, Gs, Ww, Wo, Wo, Ww, Wo, Wo, Wo, Wo, Gs^Vc, Ww, Ww, Ww, Wo, Ww, Ww, Wo, Ww, Ww, Mm, Gs, Rp, Rp, Hh, Hhd^Vhhr, Mm, Hh, Hh, Mm, Hh
Gs, Gg, Gg, Gs, Gs, Rd, Gs, Ww^Bw|, Gs^Vh, Gs, Ww, Ww, Gs, Wo, Ww, Ww, Ww, Wo, Ww, Wo, Wo, Ww, Gs^Vc, Gs, Gg, Gg, Gg, Rp, Rp, Chr, Rp, Mm, Rp, Hh
Gs, Gs, Gs, Gs, Gs, Gs, Gs^Vh, Gs, Gs, Gs, Ww, Ww, Ww, Wo, Ww, Ww, Gg, Ww, Ww, Wo, Ww, Ww, Gg, Gs, Gs, Gg, Hh, Hh, Hh, Rp, Hh, Rp, Mm, Rp
Ww, Ds, Gs, Gg, Gg, Rb^Gvs, Rb^Gvs, Gg, Gs, Gg, Gg, Gg, Ds, Ds, Gs, Wo, Ww, Gg, Gs, Ww, Gs, Gg, Gg, Gg, Gg, Gg, Mm, Gg, Mm, Mm, Mm, Hh, Mm, Hh
