border_size=1
usage=map

Hh, Hh, Mm^Xm, Md^Xm, Md, Md, Mm^Xm, Mm, Hhd, Rd, Rd, Hhd, Hhd, Mm, Hhd, Hhd, Gd, Hhd, Rd, Rp, Gd^Dr, Md^Xm, Mm, Mm, Md^Xm, Mm, Mm, Hhd, Mm, Hh, Hh, Re, Gg, Re
Mm, Mm^Xm, Mm^Xm, Mm^Xm, Mm, Md, Mm^Xm, Hhd, Hhd, Gd, Gd, Rd, Rd, Md, Gd, Hhd, Hhd, Rd, Hhd, Md, Md, Md, Mm, Hhd, Wog, Mm, Mm, Mm, Md, Mm, Gg^Emf, Gg, Rb^Gvs, Re
Mm, Mm, Mm, Mm^Xm, Mm^Xm, Mm, Md, Mm^Xm, Mm, Gd, Hhd, Hhd, Rd, Gd, Hhd, Gd, Gd, Rd, Hhd, Hhd, Hhd, Md, Md^Xm, Md^Xm, Ms^Xm, Mm, Mm, Hh, Hh, Hh, Mm, Hh^Vhh, Rb^Gvs, Re
Mm, Mm, Mm^Xm, Mm, Mm, Mm, Mm, Mm^Xm, Mm^Xm, Mm, Mm, Gd, Gd, Rd, Rd, Gd, Hhd, Rd, Hhd, Hhd, Gd, Md, Md^Xm, Mm, Mm, Mm, Mm, Mm, Mm, Mm, Gg, Wo, Re, Re
Mm, Ms^Xm, Mm, Mm^Xm, Qxu, Mm^Xm, Mm^Xm, Qxu, Mm, Mm, Mm, Hhd, Hhd, Gd, Hhd, Rd, Rd, Rd, Gd, Hhd, Md, Md^Xm, Mm, Mm, Mm, Hh, Mm, Hh^Vhh, Rb^Gvs, Gs, Gs, Gs, Rr, Rr
Mm, Mm, Mm, Mm, Mm^Xm, Mm, Mm, Mm^Xm, Mm, Mm, Hhd, Gd, Hhd, Hhd, Gd, Gd, Gd, Rd, Hhd, Hhd, Gs, Mm^Xm, Mm^Xm, Mm, Gg, Mm, Mm, Mm, Mm, Gs, Rr, Rr, Re, Re
Hh, Hh, Mm, Mm, Ms^Xm, Ms^Xm, Mm, Mm, Mm, Mm, Hhd, Gd^Dr, Gd, Gd, Rd, Gd^Es, Hhd, Rd, Rd, Gd, Hhd, Mm, Mm^Xm, Md, Hh, Hh, Gg, Gg, Rp, Rr, Hh, Gs, Gg, Re
Mm, Mm, Mm^Xm, Qxu, Mm, Ms^Xm, Mm, Mm, Mm, Mm, Hhd, Gs, Hhd, Gd, Rd, Gd, Hhd, Hhd, Rd, Hhd, Gs, Hhd, Mm, Hh, Hh, Chr, Rp, Rr, Gg, Gg, Gg, Gg, Gg^Efm, Gg
Mm, Mm, Ms^Xm, Mm^Xm, Mm^Xm, Mm, Mm, Mm, Mm, Mm, Gd, Hhd, Gs, Gd^Es, Gd, Gd, Gd, Gd, Md, Re, Md, Mm, Gg, Gg, Rp, Rp, Chr, Chr, Chr, Gg, Hh, Hh, Hh, Mm
Mm, Mm, Mm^Xm, Ms^Xm, Mm^Xm, Mm, Mm, Mm, Hhd, Hhd^Vhhr, Gd, Hhd, Gd, Gs, Gd, Hhd, Md, Md, Hh, Rb, Rb, Hh, Gg, Rp, Hh, Gg, Mm, Chr, Hh, Mm, Mm, Mm, Mm, Hh
Mm^Xm, Mm^Xm, Ms^Xm, Mm^Xm, Mm, Mm, Mm, Mm, Gd, Hhd, Hhd, Gd, Gd, Gs, Hhd, Hhd, Md, Ww, Rb^Em, Gs^Vh, Gg, Rb, Re, Rp, Rb^Gvs, Gs^Vh, Wwg, Wo, Mm, Mm, Ms^Xm, Ms^Xm, Mm, Mm
Mm^Xm, Ms^Xm, Mm^Xm, Ms^Xm, Mm, Mm, Mm, Mm, Hhd, Hhd, Gs, Gd^Es, Gd, Gd, Hhd, Gd^Es, Md, Hh, Gg, Gg, Gg, Gg, Gs, Rp, Gg, Rb^Gvs, Wo, Mm^Xm, Mm^Xm, Mm^Xm, Hh, Mm, Ww, Mm
Mm, Mm^Xm, Mm, Mm, Mm, Mm, Hhd, Hhd, Hhd, Gd, Gd, Gd, Hhd, Hhd, Hhd^Vhhr, Md, Md, Gg, Gs, Gs, Gs, Gs, Gs, Rp, Rd, Mm, Wo, Gg, Ww, Wo, Wo, Ww, Mm, Ww
Mm, Mm, Hh, Mm, Hh, Mm, Gd, Hhd, Gd, Gs, Hhd, Gd, Hhd, Md, Gs, Md, Hh, Hh, Hh, Gs, Gs, Gs, Gs, Rp, Rp, Hh, Wo, Wo, Hh, Mm, Hh, Gg, Mm^Xm, Mm^Xm
Mm, Hh, Mm, Hh, Hh, Gs, Gd, Gs, Gd^Es, Gd, Gs, Hhd, Hh, Gs, Gs, Hh, Gs, Gg, Gs, Gs, Gs, Rd, Gg, Gg, Wo^Bw|r, Wo, Mm, Mm, Mm, Mm, Mm, Hh, Mm^Xm, Mm
Md, Hh, Mm, Hh, Hh, Hh, Gd, Gd, Gs, Gs, Hh, Hh, Gg, Gs, Gs, Gg, Gs, Gs, Gs, Hh, Gs, Gs, Wo, Wo, Rp, Chr, Rb, Hh, Re, Mm, Hh, Ms^Xm, Mm, Mm^Xm
Re, Hh, Gs, Hh, Gs, Gs, Hh, Gs, Hh, Gs, Gs, Gg, Gs, Gs, Gs, Gs, Gs, Gs, Hh, Gs, Gs, Gs, Wo, Wo, Rp, Gg, Hh, Re, Hh, Re, Re, Re, Re, Mm
Hh, Re, Re, Hh, Md, Hh, Hh, Gs, Gs, Gs, Gs, Gs, Gs, Gs, Gg, Gs, Gs, Gs, Gs, Gg, Wo, Hh, Wog, Hh^Vhh, Rp, Gg, Gg, Mm, Mm, Hh, Mm, Mm, Mm, Re
Gs, Gs, Gs, Re, Re, Md, Re, Re, Re, Gs, Gs, Hh, Gs, Gs, Gs, Gs, Hh, Gs, Hh, Gg, Wo, Wog, Mm, Hh, Rp, Hh, Mm, Mm, Mm, Ms^Xm, Mm, Mm, Ms^Xm, Mm
Gs, Gs, Gs, Gs, Hh, Re, Gs, Gs, Gs, Re, Rb, Gg, Hh, Hh, Gs^Es, Gs, Re, Gs, Re, Hh, Ww, Mm, Mm, Mm, Rp, Mm, Mm, Mm, Ms^Xm, Ms^Xm, Wo, Mm, Mm, Mm
Gs, Gg, Gs, Gs, Gs, Gs^Es, Hh, Hh, Gs^Vc, Gs, Gg, Rb, Re, Gs, Re, Re, Gs, Re, Hh, Re, Ww, Hh, Hh, Gg, Rp, Mm, Mm, Mm, Mm, Wo, Gg^Efm, Ms^Xm, Mm, Mm
Gg, Gs, Gs, Gs, Hh, Gs, Gs, Gs, Ww, Gg, Gs^Vc, Gs, Gs, Re, Gs, Gs, Gs, Hh, Ww, Ww, Wo, Re, Re, Gs, Rp, Gs, Mm, Mm, Mm, Ms^Xm, Mm, Mm, Mm, Gg
Gg, Gs, Gs, Gs, Gs, Gs, Ww, Ww, Ww, Ww, Wo, Hh, Gs, Hh, Gg, Gg, Gg, Mm, Wo, Ww, Hh, Hh, Gs, Re, Rp, Hh, Mm, Mm, Ms^Xm, Ms^Xm, Mm, Mm, Ms^Xm, Mm
Gg, Gs, Hh, Gs, Hh, Gs^Vc, Wo, Wo, Wo, Wo, Wo, Gg, Gs, Gs, Gs, Gs, Gs, Wo, Ww, Hh, Wo, Gs^Vc, Hh, Gs, Rp, Mm, Hh, Mm, Mm, Mm, Mm, Hh, Hh, Mm
Gg, Rd, Gs, Gs, Gs, Ww, Wo, Wo, Ww, Wo, Wo, Wo, Wo, Gs^Vc, Ww, Ww, Ww, Wo, Ww, Ww, Wo, Ww, Ww, Mm, Gs, Rp, Rp, Hh, Hhd^Vhhr, Mm, Hh, Hh, Mm, Hh
Gs, Gg, Gg, Gs, Gs, Rd, Gs, Ww^Bw|, Gs^Vh, Gs, Ww, Ww, Gs, Wo, Ww, Ww, Ww, Wo, Ww, Wo, Wo, Ww, Gs^Vc, Gs, Gg, Gg, Gg, Rp, Rp, Rp, Rp, Mm, Rp, Hh
Gs, Gs, Gs, Gs, Gs, Gs, Gs^Vh, Gs, Gs, Gs, Ww, Ww, Ww, Wo, Ww, Ww, Gg, Ww, Ww, Wo, Ww, Ww, Gg, Gs, Gs, Gg, Hh, Hh, Gs, Gg, Gg, Rp, Chr, Rp
Ww, Ds, Gs, Gg, Gg, Rb^Gvs, Rb^Gvs, Gg, Gs, Gg, Gg, Gg, Ds, Ds, Gs, Wo, Ww, Gg, Gs, Ww, Gs, Gg, Gg, Gg, Gg, Gg, Gs, Gs, Hh, Gg, Hh, Hh, Mm, Hh
