border_size=1
usage=map

Mm, Gg, Mm^Xm, Gg, Mm, Gg, Gg, Rb, Rb, Gg, Mm, Gg, Mm, Mm, Mm, Gg, Mm, Gg, Mm, Gg, Hh, Gg, Wo, Ww, Ww, Gs, Gs, Hh, Hh, Hh, Mm^Xm, Mm^Xm, Md, Md, Mm^Xm, Mm, Hhd, Gd, Hhd, Gd, Hhd, Mm, Gd, Gd, Dd, Gd, Rp, Rp, Gd^Dr, Dd, Hd, Gd, Dd, Gd, Dd, Hhd, Mm^Xm, Mm^Xm, Hhd, Gg, Md, Mm
Mm^Xm, Mm^Xm, Mm, Mm, Mm^Xm, Hh, Gg, Hh, Mm, Rb, Rb, Hh, Mm, Gg, Mm, Mm^Xm, Mm^Xm, Mm, Mm^Xm, Mm, Mm^Xm, Mm, Mm, Hh, Ww, Mm, Hh, Hh, Mm, Mm^Xm, Mm^Xm, Mm^Xm, Mm, Md, Mm^Xm, Hhd, Hhd, Gd, Gd, Gd^Edb, Gd, Gd, Gd, Hhd, Gd, Gd, Rd, Gd, Gd, Gd^Esd, Gd, Hhd, Dd, Hd, Hhd, Rd, Md, Mm^Xm, Md, Md, Md, Md
Mm^Xm, Wo, Mm^Xm, Mm^Xm, Mm^Xm, Hh, Hh^Vhh, Mm, Hh, Hh, Mm, Rb, Hh, Mm, Hh, Mm, Mm, Mm, Mm, Mm, Mm^Xm, Mm, Mm, Wo, Ww, Mm^Xm, Hh, Mm, Mm, Mm, Mm, Mm^Xm, Mm^Xm, Mm, Md, Mm^Xm, Mm, Gd, Hhd, Gd, Mm, Hhd, Hhd, Gd, Gd^Dr, Gd, Rd^Esd, Dd, Gd, Dd, Hhd, Gd, Rd, Gd^Esd, Rd, Hhd, Hh, Mm^Xm, Mm^Xm, Hh^Vhh, Hhd, Md^Xm
Mm, Ww, Mm, Mm, Mm, Mm^Xm, Hh, Gg, Gg, Hh, Ch, Rb, Mm, Mm, Gg, Hh, Mm, Mm^Xm, Mm, Hh, Mm, Mm, Mm, Hh, Mm^Xm, Wo, Gg^Em, Mm, Mm, Mm, Mm^Xm, Mm, Mm, Mm, Mm, Mm^Xm, Mm^Xm, Mm, Mm, Gd, Gd, Gd, Gd, Gd, Gd, Gd, Rd, Rd, Gd, Rd, Rd, Gd, Gd, Gd, Rd, Gs, Mm, Mm, Mm, Wo, Wo, Hhd
Mm, Mm, Gg, Mm^Xm, Gg, Hh, Hh, Mm, Kh, Ch, Ch, Rb, Ch, Gg, Gs, Hh, Rb^Efm, Mm, Hh, Mm, Mm, Mm, Mm, Mm, Hh, Ww, Hh, Mm, Mm, Ms^Xm, Mm, Mm^Xm, Qxu, Mm^Xm, Mm^Xm, Qxu, Mm, Mm, Mm, Hhd, Hhd, Gd, Hhd, Rd, Rd, Gd^Es, Rp, Gd, Gd, Gd^Dr, Rd, Rd, Hhd, Rd, Rd^Gvs, Hh^Vhh, Wwg, Md^Xm, Ms^Xm, Md^Xm, Mm, Mm
Gg, Gg^Efm, Mm^Xm, Mm^Xm, Mm, Mm^Xm, Gg, Gg, Gs, Ch, Gg, Rb, Gg, Gg, Gs, Rb^Gvs, Rb^Gvs, Hh, Gg, Hh, Gg^Efm, Mm^Xm, Mm^Xm, Mm, Hh, Wo, Ww, Mm, Mm, Mm, Mm, Mm, Mm^Xm, Mm, Mm, Mm^Xm, Mm, Mm, Hhd, Gd, Hhd, Hhd, Gd, Gd, Gd, Gd, Hhd, Rp, Gd, Rd, Gd, Gd, Gd, Rd, Re, Rb^Gvs, Mm, Hh, Mm, Md^Xm, Mm^Xm, Mm
Wo, Mm, Hh, Mm, Hh, Hh, Gg, Gg, Gg, Gg, Gs, Rb, Gg, Gs, Gg, Gs, Gs^Vh, Hh, Gg, Mm, Mm, Mm, Mm, Mm, Hh, Gg, Hh, Wo, Ww, Wo, Mm, Mm, Ms^Xm, Ms^Xm, Mm, Mm, Mm, Mm, Hhd, Gd^Dr, Gd, Gd^Vhr, Rd, Gd^Dr, Hhd, Gd, Gd, Rd, Gd, Hhd, Gd, Md, Hhd, Hhd, Gd, Md, Hh, Mm, Mm, Md^Xm, Mm, Mm^Xm
Ww, Hh, Gg, Gg, Gg, Hh, Gg, Hh, Rb^Gvs, Gs, Gs^Vh, Re, Gg, Gs, Gg, Gg, Gg, Gs, Gg, Hh, Mm, Wog, Mm, Hh, Mm, Mm, Mm, Mm, Mm, Mm, Mm^Xm, Qxu, Mm, Ms^Xm, Mm, Mm, Mm, Mm, Hhd, Gs, Hhd, Gd, Rd, Gd, Hhd, Hhd, Rd, Rp, Rd, Rd, Gs, Gs, Gd^Dr, Hhd, Mm, Mm, Md^Xm, Mm, Hh, Mm, Gg^Efm, Mm
Wo, Ww, Gs, Gs, Gs, Gg, Gs, Gs, Rb^Gvs, Rb^Gvs, Gg, Re, Hh, Gg, Hh, Gg, Gg, Gg, Hh, Gg, Hh, Mm, Hh, Mm, Mm, Mm, Mm, Mm, Mm, Mm, Ms^Xm, Mm^Xm, Mm^Xm, Mm, Mm, Mm, Mm, Mm, Gd, Hhd, Gs, Gd^Es, Gd, Gd, Gd, Rd, Md, Rp, Md, Hhd, Md, Md, Gd, Mm, Md, Mm, Md, Mm, Mm, Mm, Mm, Mm
Wo, Ww, Gs^Vc, Gs, Gg, Gg, Hh, Gg, Gg, Rb^Gvs, Gg, Re, Rb, Gg, Gg, Gs, Gs, Gg, Gg, Gg, Gs^Es, Hh, Gg, Mm, Hh, Hh, Mm, Ms^Xm, Mm, Mm, Mm^Xm, Ms^Xm, Mm^Xm, Mm, Mm, Mm, Hhd, Hhd^Vhhr, Gd, Hhd, Gd, Gs, Hhd, Hhd, Hhd, Hhd, Hhd, Rd, Rp, Hhd, Md, Md, Hh, Gs^Efm, Mm, Md, Hh, Mm, Mm, Mm, Mm, Md
Wo, Ww, Ww, Gg, Gg, Gs, Gg, Gs, Gg, Hh, Gg, Gs, Gg, Rb, Rb, Hh, Gg, Gg, Gs, Gg, Gg, Mm, Gg, Hh^Vhh, Gs, Mm, Wo, Wo, Mm^Xm, Mm^Xm, Ms^Xm, Mm^Xm, Mm, Mm, Mm, Mm, Gd, Hhd, Hhd, Gd, Gd, Gs, Hhd, Hhd, Hhd, Rd, Rd, Gd, Gd^Vhr, Rd, Rp, Md, Rb^Gvs, Gs^Vh, Wwg, Md^Xm, Mm, Mm, Ms^Xm, Ms^Xm, Mm, Mm
Wo, Wo, Wo, Wo, Gg, Gs, Gs, Gg, Gs, Gg, Gg, Gs, Hh, Gg, Gg, Rb, Re, Gs, Gg, Gs, Gg, Gg, Gg, Hh, Ww, Mm, Wo, Mm, Mm^Xm, Ms^Xm, Mm^Xm, Ms^Xm, Mm, Mm, Mm, Mm, Hhd, Hhd, Gs, Gd^Es, Gd, Gd, Hh, Gd^Es, Hhd, Rd^Es, Rd, Rd, Gd, Rd, Rd, Rp, Gs, Rb^Gvs, Mm, Hh, Mm^Xm, Hh, Hh, Mm, Ww, Mm
Wo, Ww, Wo, Wo, Wo, Gs, Gg, Gs, Gg, Gs, Gg, Gs, Gg, Gg, Gg, Gg, Gs, Re, Rb, Gg, Gg, Hh, Wo, Wo, Mm^Xm, Wo, Hh, Mm, Mm, Mm^Xm, Mm, Mm, Mm, Mm, Hhd, Hhd, Hhd, Gd, Gd, Gd, Hhd, Hhd, Hhd, Gd, Hh, Gs, Rd, Rd, Rd, Rd, Rd, Rp, Rd, Mm, Ww, Gg, Ww, Wo, Wo, Ww, Mm, Ww
Wo, Ww, Wo, Ww, Wo, Wo, Ww, Wo, Wo, Gg, Wo, Gg, Gg, Gg, Gs^Vc, Gs, Gs, Gg, Gg, Rb, Rb, Hh, Ww, Hh, Mm, Mm, Mm, Mm, Mm, Mm, Hh, Mm, Hh, Mm, Gd, Hhd, Gd, Gs, Hh, Gd, Hhd, Hhd, Gd, Hhd, Hhd, Hhd, Hh, Gd, Gd, Gd^Es, Gs, Rp, Rp, Hh, Wo, Wo, Re, Re, Re, Re, Re, Hh
Ww, Wo, Wo, Ww, Wo, Wo, Wo, Gs^Vc, Wo, Wo, Ww, Wo, Wo, Ds, Wo, Gg, Gg, Gg, Wwf, Ww, Ww, Wwf, Rb, Gg, Gs, Hh, Mm, Mm^Xm, Mm, Hh, Mm, Hh, Hh, Gs, Gd, Gs, Gd^Es, Gd, Gs, Hh, Hhd, Gd, Gd, Gd, Rd, Gd, Gd, Gd, Gd, Rd, Gs, Gs, Wo^Bw|r, Wo, Re, Re, Mm, Mm, Mm, Hh, Hh, Re
Ww, Wo, Wo, Ww, Ww, Ww, Wo, Wo, Ww, Wo, Wo, Wo, Wo, Wo, Ww, Wo, Wo, Wo, Ww, Gg, Gg, Gg, Gg, Re, Re, Re, Re, Mm^Xm, Md, Hh, Mm, Hh, Hh, Hh, Gd, Gd, Gs, Gg, Hhd, Hhd^Vhhr, Rd, Rd, Gd^Dr, Gd, Hh, Gd, Gd, Hh, Gs, Gs, Wo, Wo, Rp, Chr, Hh, Mm, Mm, Mm, Mm, Ms^Xm, Mm, Hh
Wo, Ww, Wo, Ww, Wo, Wo, Wo, Ww, Wo, Wo, Wo, Ww, Wo, Wo, Wo, Wo, Wo, Wo, Wo, Ww, Ww, Gg, Wwf, Gs, Gg, Gs^Vc, Gs, Re, Re, Hh, Gs, Hh, Gs, Gs, Hh, Gs, Hh, Hh, Gs, Rd, Rd, Rd, Gd, Rd, Gd, Gs, Hh, Gs, Gs, Gs, Wo, Wo, Rp, Gg, Hh, Mm, Mm, Mm, Hh, Ms^Xm, Mm, Mm
Wo, Wo, Ww, Wo, Ww, Ww, Wo, Wo, Wo, Wo, Wo, Wo, Wo, Wo, Wo, Wo, Wo, Wo, Wo, Ww, Ww, Wo, Gg, Gg, Gg, Gg, Gs, Hh, Hh, Re, Re, Hh, Md, Hh, Hh, Gs, Gs, Gd, Gd, Rd, Gs, Rd, Gd, Gd, Hh, Gs, Hh, Gg, Wo, Hh, Wog, Hh^Vhh, Rp, Gg, Gg, Mm, Mm, Mm, Mm, Ms^Xm, Mm, Mm
Wo, Wo, Wo, Ww, Wo, Wo, Wo, Wo, Wo, Wo, Ww, Wo, Ww, Wo, Wo, Wo, Wo, Wo, Wo, Ww, Wo, Ww, Ww, Wo, Gg, Gg, Gs, Gs, Gs, Gs, Rd, Re, Re, Md, Re, Re, Re, Gs, Gs, Hh, Gs, Gs, Gs, Gs, Hh, Gs, Hh, Gg, Wo, Wog, Mm, Hh, Rp, Hh, Mm, Mm, Mm, Ms^Xm, Mm, Mm, Ms^Xm, Mm
Wo, Wo, Wo, Wo, Ww, Wo, Wo, Wo, Wo, Wo, Wo, Wo, Ss, Ww, Wo, Ww, Ww, Wo, Ww, Wo, Wo, Ww, Wwf, Wwf, Wwf, Gg, Gg, Gg, Gs, Gs, Gs, Gs, Hh, Re, Gs, Gs, Gs, Re, Rb, Gs, Hh, Hh, Gs^Es, Gs, Re, Gs, Re, Hh, Ww, Mm, Mm, Mm, Rp, Mm, Mm, Mm, Ms^Xm, Ms^Xm, Wo, Mm, Mm, Mm
Wo, Wo^Bw\r, Gg, Gs^Vc, Gg, Gg, Wo, Wo, Wo, Ww, Ss, Wo, Wo, Gg, Wo, Wo, Ww, Wo, Wo, Wo, Ww, Ww, Ww, Ww, Wwf, Gg, Gs, Gg, Gs, Gg, Gs, Gs, Gs, Gs^Es, Hh, Hh, Gs^Vc, Rd, Gg, Rb, Re, Gs, Re, Re, Gs, Re, Hh, Re, Ww, Hh, Hh, Gg, Rp, Mm, Mm, Mm, Mm, Wo, Gg^Efm, Ms^Xm, Mm, Mm
Wo, Wo, Gg, Gg, Gg, Wo, Ww, Wo, Wo, Wo, Ww, Gg, Wo, Gg, Wo, Ww, Wo, Wo, Ww^Vm, Wo, Ww, Ww, Ww, Wwf, Gg, Gg, Gg, Gs, Gg, Gs, Gs, Gs, Hh, Gs, Gs, Gs, Ww, Gg, Gs^Vc, Gs, Gs, Re, Gs, Gs, Gs, Hh, Ww, Ww, Wo, Re, Re, Gs, Rp, Gs, Mm, Mm, Mm, Ms^Xm, Mm, Mm, Mm, Gg
Wo, Wo, Wo, Wo, Wo, Wwf, Wo, Ww, Gg, Gg, Gg, Gg, Ww, Ww, Gg, Wo, Ww, Wwf, Wo, Wwf, Wo, Ww, Wo, Wo, Ww, Gg, Wo, Gs, Gg, Gs, Gs, Gs, Gs, Gs, Ww, Ww, Ww, Ww, Wo, Hh, Gs, Hh, Gg, Gg, Gg, Mm, Wo, Ww, Hh, Hh, Gs, Re, Rp, Hh, Mm, Mm, Ms^Xm, Ms^Xm, Mm, Mm, Ms^Xm, Mm
Wo, Wo, Wo, Wo, Wo, Ww, Gg, Gg, Gg, Ss, Ss, Ss, Ss, Gg, Ww, Ss, Wo, Gg, Ww, Wwf, Wo, Ww, Ww, Wo, Wo, Wo, Wo, Gs, Gg, Gs, Hh, Gs, Hh, Gs^Vc, Wo, Wo, Wo, Wo, Wo, Gg, Gs, Gs, Gs, Gs, Gs, Wo, Ww, Hh, Wo, Gs^Vc, Hh, Gs, Rp, Mm, Hh, Mm, Mm, Mm, Mm, Hh, Hh, Mm
Wo, Wo, Wo, Wo, Ww, Wo, Ww, Gg, Ss, Ss, Gg, Ww, Ss, Gg, Ss, Ss, Ww, Gg, Hh, Ww, Ww, Wwf, Ww, Wo, Wo, Wo, Gs, Gg, Gg, Rd, Gs, Gs, Gs, Ww, Wo, Wo, Ww, Wo, Wo, Wo, Wo, Gs^Vc, Ww, Ww, Ww, Wo, Ww, Ww, Wo, Ww, Ww, Mm, Gs, Rp, Rp, Hh, Hhd^Vhhr, Mm, Hh, Hh, Mm, Hh
Wo, Wo, Wo, Wo, Wo, Ww, Wo, Ww, Wo, Wo, Ww, Gg, Gg, Gg, Ss, Gg, Gg, Hh, Ss, Ww, Ss, Ss^Vhs, Gg, Wo, Wo, Wo, Wo, Gs, Gs, Gg, Gg, Gs, Gs, Rd, Gs, Ww^Bw|, Gs^Vh, Gs, Ww, Ww, Gs, Wo, Ww, Ww, Ww, Wo, Ww, Wo, Wo, Ww, Gs^Vc, Gs, Gg, Gg, Gg, Rp, Rp, Chr, Rp, Mm, Rp, Hh
Wo, Ww, Wo, Wo, Wo, Wo, Wo, Wo, Ww, Wo, Wo, Ww, Ww, Ss^Vhs, Gg, Ww, Ss, Ss, Ww, Ww, Ss, Hh, Mm^Xm, Wo, Wo, Wo, Wo, Gs^Vc, Gs, Gs, Gs, Gs, Gs, Gs, Gs^Vh, Gs, Gs, Gs, Ww, Ww, Ww, Wo, Ww, Ww, Gg, Ww, Ww, Wo, Ww, Ww, Gg, Gs, Gs, Gg, Hh, Hh, Hh, Rp, Hh, Rp, Mm, Rp
Wo, Ww, Ww, Wo, Wo, Ww, Ww, Ww, Ww, Wo, Wo, Wo, Ww, Ww, Gg, Ss, Ww, Wo, Hh, Gg, Mm, Hh, Mm, Mm^Xm, Mm^Xm, Hh, Ww, Ww, Ww, Ds, Gs, Gg, Gg, Rb^Gvs, Rb^Gvs, Gg, Gs, Gg, Gg, Gg, Ds, Ds, Gs, Wo, Ww, Gg, Gs, Ww, Gs, Gg, Gg, Gg, Gg, Gg, Mm, Gg, Mm, Mm, Mm, Hh, Mm, Hh
Wo, Wo, Ww, Wo, Wo, Wo, Wo, Wo, Ww, Wo, Wwf, Wo, Ww, Gg, Ww, Gg, Ww, Ww, Gs^Vc, Mm, Hh, Hh, Hh, Mm, Ms^Xm, Hh, Wo, Wo, Wo, Ds, Gs, Gg, Gs, Rb^Gvs, Gs, Gs, Gs, Gs, Gg, Gg, Ww, Ww, Gg, Wo, Ww, Wo, Gg, Ww, Ww, Gs^Vc, Gg, Gs, Hh, Mm, Mm, Mm, Hh, Mm, Mm^Xm, Mm, Mm, Mm
Wo, Wo, Ww, Wo, Wo, Wo, Wo, Wo, Wo^Bw\r, Wo, Gg, Ww, Gg, Ss, Wwf, Gg, Ss, Ww, Wo, Gg, Ss, Hh, Hh^Vhh, Ms, Mm^Xm, Mm, Wo, Wo, Ww, Gg, Gg, Gg, Gg, Gg, Gg, Gg, Ds, Gs, Gg, Gs^Vc, Ww, Wo, Wo, Gg, Wo, Ww, Wo, Wo, Wo, Gg, Gg, Gs, Gs, Mm, Mm, Mm, Mm, Mm^Xm, Mm, Mm, Mm, Mm
Ww, Wo, Wo, Wo, Wo, Wo, Ww, Wo, Ww, Gg, Gs^Vc, Ww, Gg, Ww, Gg, Ww, Gg, Gg, Ss, Wo, Ww, Wo, Ww, Wo, Mm, Mm^Xm, Mm^Xm, Wo, Wo, Gg, Ds, Gg, Gg, Gg, Gs, Gs, Wo, Ds, Wo, Wo, Ww, Wo, Wo, Wo, Wo, Wo, Wo, Ww, Wo, Ww, Wo, Ds, Gs^Vh, Gg, Hh, Sm, Mm, Mm, Mm, Mm^Xm, Mm, Gg
Gg, Wo, Wo, Wo, Ww, Wo, Wo, Ww, Gg, Gg, Gg, Gg, Gg, Wwf, Ww, Gg, Gg, Gg, Gg, Wo, Ww, Ss, Hh, Hh, Mm, Mm, Mm^Xm, Wo, Wo, Wo, Ww, Ww, Wo, Ds, Gs, Wo, Wo, Wo, Wo, Wo, Wo, Wo, Wo, Wo, Wo, Wo, Wo, Wo, Wo, Wo, Wo, Wo, Wo, Wo, Wog, Wo, Wog, Mm, Ww, Mm^Xm, Wo, Wo
Wo, Ww, Wo, Ww, Wo, Ww, Ww, Gg, Gg, Gg, Gg, Gg, Gg, Gg, Gg, Gg, Gg, Gg, Ss, Ww, Ww, Ss, Mm, Hh, Mm^Xm, Mm^Xm, Hh, Ww, Wo, Hh, Gg, Wo, Gg, Ww, Wo, Wo, Gg, Wo, Wo, Wo, Wo, Wo, Wo, Ww, Ww, Ww, Wo, Wo, Wo, Wo, Wo, Wo, Wo, Wo, Wo, Wog, Wog, Wog, Wog, Mm^Xm, Wog, Wog
Wo, Ww, Ww, Wo, Ww, Wo, Ww, Gg, Gg, Gg, Gs, Gg, Gg, Gg, Gg, Gg, Hh, Gg, Hh, Hh, Ww, Gg, Hh, Hh^Vhh, Mm^Xm, Mm, Wo, Wo, Wo, Wo, Ds, Gg, Wo, Wo, Gs, Wo, Gs^Vc, Wo, Wo, Ww, Wo, Ww, Ww, Wo, Ww, Wo, Wo, Wo, Ww, Wo, Wo, Wo, Wo, Wo, Wo, Mm, Mm, Wog, Wog, Wog, Wog, Wog
Wo, Wo, Wo, Gg, Gg, Wo, Gg, Gg, Ce, Gg, Gs, Gg, Gs, Gg, Gg, Gg, Mm, Mm, Mm, Mm, Wo, Hh, Mm, Mm^Xm, Mm, Mm^Xm, Mm^Xm, Wo, Wo, Wo, Hh, Gg, Gg, Gg, Gg, Gs, Gg, Wo, Wo, Wo, Wo, Wo, Wo, Wo, Wo, Wo, Ww, Gg, Gg, Ww, Ss, Gg, Gg, Gs^Vc, Wo, Mm, Hh, Sm, Mm, Wog, Mm, Gg
Ww, Ww, Ww, Gs^Vc, Gg, Gg, Gg, Ce, Ke, Ce, Gg, Gg, Gg, Gg, Hh, Gg, Gg, Mm^Xm, Mm^Xm, Mm^Xm, Ms^Xm, Wo, Hh, Mm^Xm, Wo, Ms^Xm, Ms^Xm, Gg, Wo, Wo, Wo, Wo, Wo, Gg, Wo, Gg, Wo, Wo, Ww, Ww, Wo, Wo, Wo, Wo, Gg, Ss, Sm, Ss^Vhs, Ww, Ww, Ww, Ss, Gg, Ss, Gg, Mm, Mm, Mm, Gg, Mm^Xm, Mm^Xm, Mm
Wo, Ww, Ww, Ww, Gs, Gg, Gs, Gg, Gg, Ce, Gs, Gs, Gg, Gg, Gs, Hh, Hh, Gg, Hh, Hh, Ha^Vhha, Ww, Wo, Wo, Ms, Ha, Mm^Xm, Wo, Ww, Ww, Wo, Wo, Wo, Wo, Wo, Wo, Wo, Wo, Wo, Ww, Wo, Ww, Ww, Gg, Ss, Ss, Wo, Ss, Ss, Ss, Sm, Ss, Ss, Gg, Hh, Mm, Mm, Mm, Mm, Mm, Mm^Xm, Mm
Ww, Wo, Gs, Gg, Gg, Gs, Gs, Gg, Gg, Gg, Gg, Gs, Mm, Hh, Mm, Mm, Mm^Xm, Mm, Hh, Mm, Hh, Mm^Xm, Mm, Wo, Wo, Wo, Mm^Xm, Wo, Wo, Wo, Wo, Wo, Hh, Wo, Gg, Wo, Wo, Wo, Wo, Wo, Ss, Ww, Gg, Wo, Ss, Ss, Ss, Ww, Chs, Ww, Gg, Ss, Gg, Ss, Gg, Mm, Mm, Mm, Mm^Xm, Mm, Mm^Xm, Mm^Xm
Gg, Gs, Gs, Gs, Gs, Gg, Gs, Gs, Hh, Hh, Gs, Mm, Hh, Mm, Mm, Mm, Mm^Xm, Mm^Xm, Mm^Xm, Mm^Xm, Hh, Mm, Mm^Xm, Mm^Xm, Ww, Mm^Xm, Mm^Xm, Wo, Wo, Wo, Wo, Hh, Gg, Gg, Ss^Vhs, Wo, Ss, Ss, Ww, Ss, Ss, Ds, Ss, Ww, Ss, Ww, Ss, Chs, Chs, Khs, Ss, Gg, Ss, Gg, Hh, Hh, Mm, Mm^Xm, Ms^Xm, Mm^Xm, Mm, Mm
Gs, Gs, Gg, Gs, Gg, Gg, Gs, Gs, Hh, Hh, Hh, Mm, Hh, Mm, Hh, Hh^Vhh, Mm^Xm, Mm, Hh, Hh, Gg, Gs, Hh, Mm^Xm, Mm^Xm, Mm^Xm, Hh, Wo, Hh, Hh, Wo, Hh, Gg, Ss, Ss, Ss, Ww, Ss, Ww, Ss, Ww, Ww, Ss, Ss, Ss, Ww, Ss, Chs, Ss, Chs, Ww, Ww, Ww, Mm, Hh, Mm, Mm, Mm^Xm, Mm, Ms^Xm, Ms, Mm
Gg, Gg, Gs, Gg, Gs, Gs, Hh, Hh, Hh, Mm, Mm, Mm, Gg, Hh, Gg, Gs, Mm, Hh, Mm, Mm, Gs, Gs, Hh, Mm^Xm, Mm^Xm, Mm, Hh, Mm, Hh, Wo, Hh, Gg, Gg, Gg, Ss, Ww, Gg, Ss, Ss, Ss^Vhs, Ss, Ss, Ss, Sm, Ww, Ss, Ss, Ss, Gg^Efm, Ss, Ss, Gg, Ww, Hh, Hh, Mm, Ms^Xm, Ms^Xm, Mm, Ms^Xm, Wo, Mm
Gg, Gs, Gs, Gs, Gs, Gs, Hh, Mm, Mm, Mm, Mm, Hh, Mm, Gg, Hh, Gs, Mm, Mm, Mm, Hh, Gg, Hh, Mm, Mm^Xm, Hh, Mm, Mm, Hh, Mm, Hh, Gs, Gg, Gg, Ss, Gg, Ss, Ss, Gg, Sm, Ww, Ss, Gg, Ss, Ss, Ss, Ss, Wo, Ss, Ss, Ww, Ss, Ss, Sm, Mm, Mm, Mm, Mm, Mm, Mm^Xm, Ms^Xm, Mm, Wo
Ww, Gg, Gg, Gs, Gg, Hh, Hh, Mm, Mm, Mm^Xm, Mm^Xm, Hh, Hh, Hh, Mm, Mm, Mm, Hh, Gg, Gg, Mm, Mm, Mm^Xm, Mm^Xm, Mm^Xm, Mm, Mm, Mm, Hh, Gs, Gg, Gg, Gg, Gg, Gg, Gg, Gg, Gg, Ss, Ss, Ss, Ss, Ss, Gg, Ss, Ss, Ss, Ss, Sm, Ss, Ss, Ss, Gg, Ss, Mm, Mm, Wo, Mm, Mm^Xm, Mm, Mm, Mm
Ww, Gs^Vc, Gg, Gg, Hh, Hh, Mm, Mm^Xm, Mm^Xm, Mm^Xm, Mm^Xm, Mm, Mm, Mm, Mm, Mm, Hh, Gg, Hh, Mm^Xm, Mm^Xm, Mm^Xm, Mv, Md^Xm, Mm^Xm, Hh, Mm^Xm, Hh, Mm, Gs, Hh, Hh, Mm, Gg, Gg, Gg, Gg, Ss, Wo, Ss, Wo, Ww, Ss, Gg^Efm, Ss, Ww, Gg, Ww, Ss, Ww, Ss^Vhs, Ss, Ww, Hh, Wo, Wo, Mm, Mm^Xm, Ms^Xm, Mm, Mm, Mm
Gg, Gs, Hh, Hh, Mm, Mm, Mm^Xm, Mm^Xm, Ms^Xm, Mm^Xm, Mm^Xm, Mm, Ms, Mm, Hh^Vhh, Mm, Mm, Hh, Hh, Mm, Md^Xm, Mm, Uh, Uh, Hhd, Mm^Xm, Md, Mm^Xm, Hh, Gs, Mm^Xm, Mm, Mm^Xm, Hh, Gg, Ss, Gg, Gg, Ss, Ss, Ss, Ss, Gg, Ss, Gg, Ss, Ww, Ww, Ss, Ss, Ww, Ss, Gg, Ww, Hh, Gg, Hh, Mm, Mm, Ms^Xm, Mm^Xm, Mm^Xm
Gs, Gg, Hh, Mm, Mm, Mm^Xm, Ms^Xm, Ms^Xm, Mm^Xm, Mm^Xm, Mm^Xm, Mm, Mm, Wo, Rb^Emf, Rb^Gvs, Gg, Hh, Gg, Mm, Md^Xm, Md^Xm, Md, Uh, Uh, Uh, Rd^Vhr, Mm^Xm, Mm^Xm, Mm^Xm, Md, Mm^Xm, Wo, Mm, Gg, Gg, Gg, Ss, Gg, Gg, Gg, Gg, Gg, Gg, Ww, Ss, Ss, Ss, Ss, Gg, Ss, Ss, Wo, Mm, Hh, Hh, Mm, Mm, Ms^Xm, Ms^Xm, Mm, Mm^Xm
Gg, Hh, Mm, Hh, Mm^Xm, Ms^Xm, Mm^Xm, Mm^Xm, Mm^Xm, Mm^Xm, Mm^Xm, Mm, Gg, Mm, Hh, Rb^Gvs, Hh, Hh, Hh, Hh, Md^Xm, Md^Xm, Hhd, Uh, Uh, Rd, Uh, Hhd, Hhd, Md, Md, Mm^Xm, Mm^Xm, Mm, Mm, Gs, Gg, Gg, Gg, Gg, Gg, Gg, Ss, Gg, Ss, Ss, Ss, Gg, Gg, Ss, Gg, Gg, Gg, Ww, Ww, Wo, Wo, Ms, Mm, Mm, Mm^Xm, Mm^Xm
Hh, Hh, Mm, Mm, Mm^Xm, Mm^Xm, Mm, Mm, Mm^Xm, Mm^Xm, Mm^Xm, Hh, Hh, Mm, Mm, Hh, Mm, Mm, Mm^Xm, Mm^Xm, Rd^Vhr, Hhd, Rd^Es, Uh, Uh, Rd, Uh, Uh, Rd^Dr, Hhd, Hhd, Rd^Vhr, Mm^Xm, Mm^Xm, Mm^Xm, Hh, Hh, Gg, Gg, Ss, Gg, Gg, Gg, Gg, Ss, Gg, Gg, Gg, Ss, Gg, Ss^Vhs, Gg, Ww, Ww, Sm, Hh, Mm, Mm, Mm^Xm, Mm, Mm^Xm, Mm
Hh, Mm, Mm, Mm, Mm, Mm, Hh, Mm, Mm, Mm, Mm^Xm, Mm, Mm, Mm^Xm, Mm^Xm, Mm^Xm, Mm^Xm, Mm^Xm, Mm, Mm, Hhd, Hhd, Uh, Hhd, Hhd, Rd, Gd, Uh, Uh, Gs, Hhd, Md, Md, Mm^Xm, Md, Mm, Gs, Gg, Gg, Gg, Gg, Gg, Gg, Ss, Gg, Gg, Gg, Ss, Ss, Gg, Ww, Ww, Hh, Wo, Hh, Hh, Mm, Ms^Xm, Mm, Mm^Xm, Mm, Mm
Hh, Hh, Mm, Mm^Xm, Mm^Xm, Hh, Gg, Hh, Mm, Mm^Xm, Wog, Mm^Xm, Mm, Mm^Xm, Mm, Mm, Mm^Xm, Mm, Mm, Mm, Uh, Uh, Rd^Dr, Uh, Rd, Uh, Rd^Vhr, Rd, Rd, Rd, Uh, Rd, Rd^Es, Hhd, Hhd, Hhd, Gs, Gg, Gs, Ce, Ce, Gg, Gg, Gg, Gg, Gg, Gg, Ss, Gg, Gg, Sm, Ss, Ww, Ww, Mm, Mm, Mm^Xm, Mm^Xm, Mm, Mm, Mm, Mm
Mm, Mm, Mm, Mm, Hh, Hh^Vhh, Gg, Mm, Mm^Xm, Mm^Xm, Mm, Gg, Mm^Xm, Mm, Mm, Mm^Xm, Mm^Xm, Mm^Xm, Mm, Hhd, Uh, Uh, Rd^Es, Uh, Rd, Uh, Uh, Gd, Uh, Uh, Md, Uh, Rd, Rd, Gs, Gs, Gs, Gs, Gg, Ce, Ke, Ce, Gg, Gg, Gs, Gg, Gg, Gg, Gg, Ss, Ss, Ss, Ww, Mm, Mm, Mm, Mm^Xm, Mm, Mm^Xm, Mm, Mm, Mm
Rd, Mm, Wog, Mm^Xm, Hh, Gg, Gg, Mm, Mm^Xm, Mm^Xm, Mm, Mm, Rd, Mm^Xm, Mm, Mm^Xm, Mm^Xm, Mm^Xm, Hhd, Hhd, Uh, Rd, Gd, Uh, Gs, Gd, Uh, Rd^Dr, Uh, Gs, Uh, Uh, Uh, Uh, Uh, Rd, Gs, Gs, Gs, Gg, Gs, Ce, Gs, Gg, Gg, Gg, Gg, Gg, Gg, Ss, Gg^Efm, Ww, Gg, Mm, Gg, Mm, Mm^Xm, Mm, Mm^Xm, Hh, Hh, Mm
