border_size=1
usage=map

Gg          , Gg          , Gs^Fms      , Gs^Fms      , Gs^Es       , Gg          , Gs^Fms      , Gs^Fms      , Gs^Fms      , Gs^Fms      , Gs^Fds      , Gs^Fms      , Gg          , Gs^Fds      , Gg          , Wo          , Wo          , Gg          , Gg          , Gg          , Gg          , Gg          , Gg          , Gg          , Rr          , Gg          
Gg^Es       , Gs          , Gs^Fds      , Gs^Fds      , Gg          , Gs^Fms      , Gs          , Gg          , Ce          , Gs^Fms      , Ce          , Gg          , Ce          , Gg          , Ce          , Ww          , Ww          , Wwg         , Gg          , Gg^Efm      , Gg          , Gg          , Rr          , Rr          , Gg          , Gg          
Gg          , Gs^Fms      , Gg          , Gs^Fds      , Gg^Efm      , Gg          , Ce          , Ce          , Rrc         , Ce          , Rrc         , Ce          , Rr          , Ce          , Rp^Vhcr     , Ce          , Ce          , Ww          , Ww          , Gg          , Rr          , Rr          , Gg^Efm      , Gg          , Ss          , Ss          
Gg          , Gs^Fds      , Gs          , Gg          , Ce          , Ce          , Rrc         , Rrc         , Rp^Vhcr     , Rr          , Rrc         , Rrc         , Rrc         , Rr          , Rp^Vhcr     , Rp^Vhcr     , Rr          , Ce          , Rr          , Wwf^Bw/     , Wwf         , Gg          , Gg          , Gg^Em       , Ss          , Gg          
Gs^Fds      , Gg^Es       , Gs^Fds      , Gs^Fms      , Ce          , Rrc         , Rp^Vhcr     , Rp^Vhcr     , Rrc         , Rr^Vhc      , Rp^Vhcr     , Rp^Vhcr     , Rrc         , Rp^Vhcr     , Rrc         , Rr          , Rb          , Rr          , Ce          , Wwf         , Wwg         , Ww          , Sm          , Gg^Em       , Ss          , Ss          
Gs          , Gs^Fds      , Gs          , Gg          , Ce          , Rr          , Rrc         , Rr^Vhc      , Rrc         , Rr          , Rrc         , Rr^Vhc      , Rp^Vhcr     , Rrc         , Rb          , Rr          , Gs^Vh       , Rp          , Gs^Vc       , Ce          , Ce          , Wwg         , Wwg         , Sm          , Gg^Efm      , Ss          
Gs^Fms      , Gg          , Gs          , Gs          , Ce          , Rrc         , Rp^Vhcr     , Rrc         , Rr^Vhc      , Rr^Vhc      , Rr^Vhc      , Rrc         , Rrc         , Rr          , Gs^Vh       , Gs^Vh       , Gs^Vc       , Gs^Vh       , Gs^Vc       , Gs^Vc       , Ce          , Ww          , Wwg         , Ss          , Ss          , Gg          
Gs          , Gs^Fms      , Gs          , Ce          , Rr          , Rrc         , Rr^Vhc      , Rr^Vhc      , Gg          , Gg          , Rrc         , Rr          , Gs^Vh       , Rb          , Rb          , Rp^Vhcr     , Gs^Vh       , Gs^Vc       , Gd^Vhr      , Gs^Vc       , Ce          , Ww          , Ww          , Wwg         , Ss          , Gg          
Gs          , Gs          , Gs          , Ce          , 1 Rr        , Rrc         , Rr^Vhc      , Rr^Vhc      , Rr^Vhc      , Gg^Fet      , Rrc         , Rrc         , Rr          , Gs^Vc       , Rb          , Gs^Vh       , Rb          , Rb          , Gs^Vh       , Gs^Vc       , Gs^Vc       , Ce          , Ww          , Wwg         , Ss          , Ss          
Gs          , Gs          , Rr          , Rr          , Rr          , Rrc         , Rrc         , Rr^Vhc      , Rr^Vhc      , Rr^Vhc      , Rrc         , Gs^Vc       , Gs^Vh       , Gd^Vhr      , Gs^Vh       , Rb          , Gs^Vc       , Gs^Vc       , Gs^Vh       , Rb          , Gs^Vc       , Ce          , Ww          , Ss          , Ss          , Ss          
Rr          , Rr          , Rb^Gvs      , Ce          , Rr          , Rrc         , Rr^Vhc      , Rrc         , Rrc         , Rrc         , Rr          , Gs^Vh       , Rb          , Rr          , Gs^Vh       , Rb          , Gs^Vc       , Gd^Vhr      , Gs^Vc       , Rb          , Gs^Vc       , Ce          , Ww          , Ww          , Ss          , Ss          
Rb^Gvs      , Rb^Gvs      , Rb^Gvs      , Ce          , Rr          , Rr^Vhc      , Rr^Vhc      , Rr          , Rp^Vhcr     , Rp          , Rr          , Rb          , Gs^Vc       , Gd^Vhr      , Rb          , Rb          , Gs^Vh       , Rp          , Gs^Vh       , Gs^Vc       , Gs^Vc       , Ce          , Ww          , Wwg         , Ww          , Ww          
Rb^Gvs      , Rb^Gvs      , Rb^Gvs      , Ce          , Ce          , Rr          , Rr          , Rr^Vhc      , Rr          , Rr          , Rp^Vhcr     , Rb          , Rb          , Rp          , Gd^Vhr      , Gs^Vc       , Rp^Vhcr     , Gs^Vc       , Gs^Vc       , Gs^Vc       , Ce          , Ce          , Ww          , Ww          , Ss          , Ss          
Rb^Gvs      , Rb^Gvs      , Rb^Gvs      , Rb^Gvs      , Ce          , Rr          , Rr          , Rr^Vhc      , Rr          , Rr^Vhc      , Gs^Vh       , Rb          , Gs^Vh       , Rb          , Gs^Vc       , Rb          , Gs^Vh       , Gs^Vh       , Gs^Vc       , Rb          , Ce          , Ww          , Wwg         , Ss          , Ss          , Sm          
Rb^Gvs      , Rb^Gvs      , Rb^Gvs      , Rb^Gvs      , Rb^Gvs      , Ke          , Ce          , Rr          , Rr          , Rr^Vhc      , Rr          , Rb          , Gs^Vc       , Gs^Vc       , Gs^Vc       , Gs^Vh       , Gs^Vc       , Gs^Vc       , Rb          , Ce          , Ww          , Ww          , Wwf         , Ss          , Sm          , Ss          
Rd          , Rb^Gvs      , Rb^Gvs      , Rb^Gvs      , Rb^Gvs      , Ke          , Ke          , Ke          , Ce          , Rr          , Ce          , Re          , Ce          , Gs^Vc       , Ce          , Rb          , Ce          , Gs^Vc       , Ce          , Ce          , Ww          , Wwg         , Ss          , Sm          , Wwf         , Ss          
Rb^Gvs      , Rb^Gvs      , Rb^Gvs      , Rb^Gvs      , Rb^Gvs      , Rb^Gvs      , Rb^Gvs      , Rb^Gvs      , Rb^Gvs      , Ce          , Rb^Gvs      , Re          , Rb^Gvs      , Ce          , Rb^Gvs      , Ce          , Rb^Gvs      , Ce          , Ww          , Ww          , Wwg         , Sm          , Ss          , Sm          , Sm          , Sm          
Rd          , Rb^Gvs      , Rb^Gvs      , Rb^Gvs      , Rb^Gvs      , Rb^Gvs      , Rb^Gvs      , Rb^Gvs      , Rb^Gvs      , Rb^Gvs      , Rb^Gvs      , Re          , Rb^Gvs      , Rb^Gvs      , Rb^Gvs      , Rb^Gvs      , Rb^Gvs      , Rb^Gvs      , Ww          , Ww          , Sm          , Sm          , Ss          , Wwf         , Gg          , Sm          
