border_size=1
usage=map

Gg, Gg, Gs^Fms, Gs^Fms, Gs^Es, Gg, Gs^Fms, Gs^Fms, Gs^Fms, Gs^Fms, Gs^Fds, Gs^Fms, Gg, Gs^Fds, Gg, Wo, Wo, Gg, Gs^Fds, Gg, Gs^Fds, Gg, Gs^Fds, Gg, Rr, Gg
Gg^Es, Gs, Gs^Fds, Gs^Fds, Gg, Gs^Fms, Gs, Gg, Ce, Gs^Fms, Ce, Gg, Ce, Gg, Ce, Ww, Ww, Wwg, Gs^Fds, Gg^Efm, Gg, Gg, Rr, Rr, Gg, Gs^Fds
Gg, Gs^Fms, Gg, Gs^Fds, Gg^Efm, Gg, Ce, Ce, Rrc, Ce, Rrc, Ce, Rr, Ce, Rp^Vhcr, Ce, Ce, Ww, Ww, Gg, Rr, Rr, Gg^Efm, Gg, Gs^Fds, Gll^Fp
Gg, Gs^Fds, Gs, Gg, Ce, Ce, Rrc, Rrc, Rp^Vhcr, Rr, Rrc, Rrc, Rrc, Rr, Rp^Vhcr, Rp^Vhcr, Rr, Ce, Rr, Wwf^Bw/, Wwf, Gg, Gg, Gg^Em, Gs^Fds, Gg
Gs^Fds, Gg^Es, Gs^Fds, Gs^Fms, Ce, Rrc, Rp^Vhcr, Rp^Vhcr, Rrc, Rr^Vhc, Rp^Vhcr, Rp^Vhcr, Rrc, Rp^Vhcr, Rrc, Rr, Rb, Rr, Ce, Wwf, Wwg, Ww, Ww, Gg^Em, Gs^Fms, Gs^Fds
Gs, Gs^Fds, Gs, Gg, Ce, Rr, Rrc, Rr^Vhc, Rrc, Rr, Rrc, Rr^Vhc, Rp^Vhcr, Rrc, Rb, Rr, Gs^Vh, Rp, Gs^Vc, Ce, Ce, Wwg, Wwg, Ww, Ww, Gg
Gs^Fms, Gg, Gs, Gs, Ce, Rrc, Rp^Vhcr, Rrc, Rr^Vhc, Rr^Vhc, Rr^Vhc, Rrc, Rrc, Rr, Gs^Vh, Gs^Vh, Gs^Vc, Gs^Vh, Gs^Vc, Gs^Vc, Ce, Hh, Gg, Ss, Ss, Ww
Gs, Gs^Fms, Gs, Ce, Rr, Rrc, Rr^Vhc, Rr^Vhc, Gg, Gg, Rrc, Rr, Gs^Vh, Rb, Rb, Rp^Vhcr, Gs^Vh, Gs^Vc, Gd^Vhr, Gs^Vc, Ce, Gg, Hh, Hh, Gg, Gg
Gs, Gs, Gs, Ce, Rr, Rrc, Rr^Vhc, Rr^Vhc, Rr^Vhc, Gg^Fet, Rrc, Rrc, Rr, Gs^Vc, Rb, Gs^Vh, Rb, Rb, Gs^Vh, Gs^Vc, Gs^Vc, Ce, Gs, Gg, Hh, Hh
Gs, Gs, Rr, Rr, Rr, Rrc, Rrc, Rr^Vhc, Rr^Vhc, Rr^Vhc, Rrc, Gs^Vc, Gs^Vh, Gd^Vhr, Gs^Vh, Rb, Gs^Vc, Gs^Vc, Gs^Vh, Rb, Gs^Vc, Ce, Gs, Gg, Gs, Gs
Rr, Rr, Rb^Gvs, Ce, Rr, Rrc, Rr^Vhc, Rrc, Rrc, Rrc, Rr, Gs^Vh, Rb, Rr, Gs^Vh, Rb, Gs^Vc, Gd^Vhr, Gs^Vc, Rb, Gs^Vc, Ce, Gs, Hh, Gs, Gs
Rb^Gvs, Rb^Gvs, Rb^Gvs, Ce, Rr, Rr^Vhc, Rr^Vhc, Rr, Rp^Vhcr, Rp, Rr, Rb, Gs^Vc, Gd^Vhr, Rb, Rb, Gs^Vh, Rp, Gs^Vh, Gs^Vc, Gs^Vc, Ce, Gs, Gs, Hh, Hh
Rb^Gvs, Rb^Gvs, Rb^Gvs, Ce, Ce, Rr, Rr, Rr^Vhc, Rr, Rr, Rp^Vhcr, Rb, Rb, Rp, Gd^Vhr, Gs^Vc, Rp^Vhcr, Gs^Vc, Gs^Vc, Gs^Vc, Ce, Ce, Hh, Hh, Mm, Mm
Rb^Gvs, Rb^Gvs, Rb^Gvs, Rb^Gvs, Ce, Rr, Rr, Rr^Vhc, Rr, Rr^Vhc, Gs^Vh, Rb, Gs^Vh, Rb, Gs^Vc, Rb, Gs^Vh, Gs^Vh, Gs^Vc, Rb, Ce, Hh, Hh, Gs, Mm, Mm
Rb^Gvs, Rb^Gvs, Rb^Gvs, Rb^Gvs, Rb^Gvs, Ke, Ce, Rr, Rr, Rr^Vhc, Rr, Rb, Gs^Vc, Gs^Vc, Gs^Vc, Gs^Vh, Gs^Vc, Gs^Vc, Rb, Ce, Hh, Hh, Hh, Mm, Hh, Mm
Rd, Rb^Gvs, Rb^Gvs, Rb^Gvs, Rb^Gvs, Ke, Ke, Ke, Ce, Rr, Ce, Re, Ce, Gs^Vc, Ce, Rb, Ce, Gs^Vc, Ce, Ce, Gs, Mm, Mm, Mm, Hh, Mm
Rb^Gvs, Rb^Gvs, Rb^Gvs, Rb^Gvs, Rb^Gvs, Rb^Gvs, Rb^Gvs, Rb^Gvs, Rb^Gvs, Ce, Rb^Gvs, Re, Rb^Gvs, Ce, Rb^Gvs, Ce, Rb^Gvs, Ce, Rb^Gvs, Rb^Gvs, Rb^Gvs, Hh, Hh, Mm, Hh, Mm
Rd, Rb^Gvs, Rb^Gvs, Rb^Gvs, Rb^Gvs, Rb^Gvs, Rb^Gvs, Rb^Gvs, Rb^Gvs, Rb^Gvs, Rb^Gvs, Re, Rb^Gvs, Rb^Gvs, Rb^Gvs, Rb^Gvs, Rb^Gvs, Rb^Gvs, Rb^Gvs, Rb^Gvs, Rb^Gvs, Gg, Hh^Gvs, Hh, Mm, Mm
