border_size=1
usage=map

Hh, Hh, Hh, Mm, Mm, Mm, Mm, Mm, Mm, Gg, Mm, Mm, Mm, Hh, Ms, Mm^Xm, Ms^Xm, Mm^Xm, Mm^Xm, Xu, Uh, Uh, Ql, Uh, Ql, Uh, Uh, Uu, Uu, Uue, Uue, Uu, Uu, Uu, Uu, Uh, Xu, Xu
Hh, Hh^Fds, Mm, Mm, Hh, Hh^Fds, Mm, Mm, Mm, Mm, Mm, Mm, Mm, Hh, Ms, Ms, Ms, Ms, Mm^Xm, Xu, Ql, Ql, Xu, Ql, Xu, Ql, Ql, Uu, Uh, Uh, Uh, Uue, Uh, Uh, Uh, Uu, Uu, Uu
Gg, Mm, Hh^Fds, Mm, Mm, Hh, Mm, Mm, Mm, Hh, Hh, Hh, Gg^Efm, Mm, Ww, Ww, Ms, Mm, Ql, Ql, Xu, Xu, Urb, Xu, Urb, Xu, Xu, Ql, Ql, Ql, Ql, Uue, Ql, Uh, Ql, Uh, Uh, Uh
Gg, Mm, Mm, Mm, Hh^Fds, Mm, Hh^Fds, Gg, Hh, Mm, Hh, Mm, Hh, Wo, Mm, Mm, Mm, Ql, Xu, Xu, Urb, Urb, Urb, Urb, Cud, Urb, Cud, Xu, Xu, Xu, Xu, Ql^Bs|, Xu, Ql, Ql, Ql, Ql, Uh
Hh^Fp, Gll^Fp, Hh, Hh^Fp, Gs^Fms, Hh, Hh^Fp, Mm, Hh^Fp, Mm, Hh, Gg, Wo, Wo, Gg, Mm, Xu, Xu, Urb, Urb, Urb, Urb, Urb, Urb, Cud, Kud, Cud, Xu, Urb, Urb, Urb, Urb, Cud, Xu, Xu, Xu, Xu, Ql
Gs^Fms, Gs^Fds, Gs^Fds, Gs^Fds, Gs^Fds, Gs^Fds, Gs^Fds, Gs^Fds, Hh, Mm, Mm, Hh, Ww, Hh, Mm, Mm, Xu, Urb, Urb, Urb, Urb, Urb, Urb, Urb, Urb, Cud, Urb, Xu, Urb, Urb, Urb, Urb, Urb, Xu, Urb, Xu, Urb, Xu
Gll^Fp, Gs^Fds, Gs^Fds, Gs^Fms, Gs^Fds, Gll^Fp, Gs^Fds, Gs^Fds, Gg, Gs^Fds, Gg, Ww, Hh, Gg^Efm, Mm, Mm^Xm, Xu, Xu, Xu, Urb, Urb, Urb, Urb, Urb, Urb, Urb, Urb, Xu, Urb, Urb, Urb, Urb, Urb, Urb, Urb, Urb, Urb, Urb
Gg, Gs^Fds, Gs^Fds, Gs^Fds, Gs^Fms, Gs^Fds, Gg, Gg, Rb, Gg, Ww, Ww, Mm, Mm, Mm, Mm^Xm, Cud, Urb, Urb, Xu, Xu, Urb, Urb, Urb, Urb, Urb, Cud, Urb, Xue, Urb, Xue, Urb, Urb, Urb, Urb, Urb, Urb, Urb
Gs^Fds, Gs^Fds, Gs^Fds, Gs^Fds, Gg, Gs^Fds, Rb, Rb, Hh, Rb, Wwf, Gg, Hh, Hh, Rb, Mm, Urb, Urb, Urb, Urb, Urb, Urb, Xu, Xu, Urb, Urb, Xue, Ur, Ur, Xue, Uu^Uf, Xue, Xue, Urb, Xue, Urb, Urb, Xu
Gs^Fds, Gg, Gs^Fds, Gg, Rb, Rb, Gg, Hh, Hh, Ww, Gg, Rb, Rb, Rb, Hh, Rb, Cud, Urb, Urb, Urb, Urb, Urb, Urb, Xu, Xue, Xue, Uue^Ii, Uue, Uue^Ii, Ur, Ur, Uue^Ii, Uue, Xue, Uu^Uf, Xue, Urb, Urb
Rb, Rb, Rb, Re, Gs, Gg, Hh, Mm, Ww, Wo, Gg, Gg, Gs, Hh, Mm, Xu, Xu, Urb, Urb, Urb, Urb, Urb, Urb, Urb, Xue, Xue, Uue, Uue^Ii, Uue^Emf, Uue, Qxu^Ii, Ur, Ur, Uue, Uue, Xue, Urb, Urb
Gg, Gg, Gg, Gg, Gg, Gs, Gg, Hh, Ww, Hh, Gg, Gg, Mm, Hh, Mm, Mm, Xu, Urb, Urb, Urb, Urb, Urb, Urb, Urb, Xue, Uu^Uf, Uue, Uue^Emf, Uue, Uue^Emf, Qxu, Qxu^Ii, Qxu^Ii, Ur, Ur, Xue, Xue, Urb
Gg, Gs^Fms, Gg, Gg, Gg, Gg, Ww, Ww, Hh, Gg, Gg, Hh, Mm, Gg, Mm, Mm, Mm, Xu, Xu, Xu, Xu, Xue, Xue, Urb, Urb, Xue, Xue, Uue^Em, Uue, Uue, Uue^Ii, Qxu^Ii, Uue, Uue, Uue, Ur, Ur, Xu
Gg, Gg, Wo, Gg, Wo, Wo, Ww, Mm, Mm, Gg, Gg, Hh, Hh, Mm, Mm, Mm, Mm, Xu, Xu, Xu, Urb, Urb, Urb, Urb, Urb, Urb, Urb, Xue, Xue, Xue, Uu^Uf, Uue^Ii, Uue, Uue, Uue, Uue^Ii, Xue, Urb
Gg, Ww, Ww, Ww, Ww, Wo, Wo, Gg, Ww, Ww, Ww, Gg, Gg, Mm, Mm, Mm, Mm, Mm, Ql, Xu, Urb, Urb, Urb, Urb, Urb, Urb, Urb, Urb, Urb, Xue, Xue, Xue, Uue, Uue, Uue^Emf, Xue, Urb, Xu
Ww, Ww, Ww, Ww, Gg, Hh, Hh, Ww, Gg, Ww, Wo, Gg, Hh, Gg, Hh, Mm, Mm, Mm, Ql, Xu, Xu, Urb, Urb, Urb, Urb, Urb, Urb, Urb, Urb, Urb, Urb, Xue, Xue, Uue, Xue, Xue, Urb, Urb
Ww, Ww, Gg, Gg, Gg, Hh, Gg, Gg, Gg, Gg, Mm, Wo, Wo, Hh, Gg, Mm, Mm, Mm, Ql, Xu, Xu, Urb, Urb, Urb, Urb, Urb, Urb, Urb, Urb, Urb, Cud, Urb, Urb, Urb, Urb, Urb, Urb, Urb
Gg, Gg, Gs, Gg, Gg, Hh, Hh, Gg, Gs, Gg, Gg, Ww, Ww, Wo, Ww, Mm, Hh, Mm, Mm, Ql, Ql, Xu, Xu, Xu, Xu, Urb, Xu, Urb, Urb, Urb, Xu, Xu, Urb, Urb, Urb, Urb, Urb, Urb
Gg, Gg, Gs, Gs, Gs, Gg, Gs, Gg, Gs, Gg, Gg, Gg, Hh, Ww, Gg^Efm, Ww, Wo, Mm, Mm, Mm, Mm, Ql, Ql, Ql, Ql, Xu, Ql, Xu, Xu, Urb, Xu, Urb, Urb, Urb, Urb, Urb, Urb, Urb
Gs, Gs, Gs, Gg, Hh, Gs^Fms, Hh, Gg, Hh, Hh, Hh, Hh, Mm, Hh, Ms, Ms, Wo, Wo, Ww, Mm, Ms, Mm, Mm, Mm, Mm, Ql, Hh, Ql, Ql, Xu, Xu, Xu, Xu, Urb, Xu, Urb, Urb, Urb
Gg, Gg, Hh, Gs, Hh, Hh, Hh, Hh, Hh, Gg^Efm, Hh, Hh, Mm, Mm, Ha, Ms, Ww, Mm, Ww, Ms, Ms^Xm, Ms, Mm, Mm, Hh, Mm, Mm, Mm, Mm, Ql, Ql, Ql, Ql, Xu, Xu, Urb, Xu, Xu
Gg, Gll^Fp, Hh, Gg, Mm, Hh, Mm, Hh, Mm, Mm, Mm, Mm, Mm, Hh, Mm, Ms, Ms, Ms, Wo, Ms, Ms, Ms, Ms^Xm, Ms^Xm, Ms^Xm, Hh, Mm, Mm, Hh, Mm, Mm, Mm, Mm, Ql, Ql, Xu, Ql, Ql
Gg, Hh, Hh, Hh, Hh, Mm, Mm, Mm, Hh, Wo, Gg, Hh, Hh, Mm, Hh, Mm, Hh, Ms, Ms, Ms, Ms^Xm, Ms^Xm, Hh, Ms^Xm, Hh, Ms^Xm, Ms^Xm, Ms^Xm, Mm, Hh, Mm, Ms^Xm, Mm, Mm, Mm, Ql, Ql, Ql
