border_size=1
usage=map

Gd, Gd, Gd, Gd, Gd, Gd, Gd, Gd, Gd, Gd, Gd, Gd, Gd, Gd, Gd, Gd, Gd, Gd, Gd, Gd, Gd, Gd, Gd, Gd, Gd, Gd, Gd, Gd, Gd, Gd, Gd, Gd, Gd, Gd, Gd, Gd, Gd, Hhd, Hhd, Hhd, Hhd, Rd, Rd, Hhd, Md, Md, Hhd, Hhd, Hhd, Gd, Hhd, Md, Hhd, Hhd, Hhd, Md, Hhd, Rd, Gd^Es, Hhd, Hhd, Hhd, Gd, Hh, Hh, Hhd, Hh, Hhd, Hh, Gg, Gg, Gg
Gd, Gd, Gd, Gd, Gd, Gd, Gd, Gd, Gd, Gd, Gd, Gd, Gd, Gd, Gd, Gd, Gd, Gd, Gd, Gd, Gd, Gd, Gd, Gd, Gd, Gd, Gd, Gd, Gd, Gd, Gd, Gd, Gd, Gd, Gd, Gd, Hhd, Hhd, Hhd, Hhd, Md, Gd^Vo, Md, Rd, Rd, Hhd, Md, Hhd, Md, Hhd, Md, Hhd^Dr, Md, Md, Md, Hhd, Hhd, Rd, Hhd, Hhd, Hhd, Hhd, Md, Gd, Md, Hh, Md, Hh, Hh, Gg, Gg, Gg
Gd, Gd, Gd, Gd, Gd, Gd, Gd, Gd, Gd, Gd, Gd, Gd, Gd, Gd, Gd, Gd, Gd, Gd, Gd, Gd, Gd, Gd, Gd, Gd, Gd, Gd, Gd, Gd, Gd, Gd, Gd, Gd, Gd, Gd, Gd, Gd, Hhd, Md, Md, Md, Md, Md, Md, Md, Rd, Hhd, Md, Md, Md, Md, Md, Md, Hhd, Md, Hhd, Md, Hhd^Vhhr, Rd, Hhd, Hhd, Md, Hhd, Hhd, Hhd, Hh, Hh, Hhd, Hh, Md, Gg, Gg, Gg
Gd, Gd, Gd, Gd, Gd, Gd, Gd, Gd, Gd, Gd, Gd, Gd, Gd, Gd, Gd, Gd, Gd, Gd, Gd, Gd, Gd, Gd, Gd, Gd, Gd, Gd, Gd, Gd, Gd, Gd, Gd, Gd, Gd, Gd, Gd, Gd, Md, Hhd, Hhd, Hhd, Hhd, Hhd, Md, Hhd, Md, Rd, Rd, Md, Md, Hhd, Hhd, Hhd, Hhd, Hhd, Hhd, Md, Md, Rd, Gd, Gd, Md, Md, Hh, Md, Md, Hhd, Hh, Md, Md, Gg, Gg, Gg
Gd, Gd, Gd, Gd, Gd, Gd, Gd, Gd, Gd, Gd, Gd, Gd, Gd, Gd, Gd, Gd, Gd, Gd, Gd, Gd, Gd, Gd, Gd, Gd, Gd, Gd, Gd, Gd, Gd, Gd, Gd, Gd, Gd, Gd, Gd, Gd, Md, Md, Md, Md, Hhd, Md, Md, Md, Md, Md, Rd, Md, Md, Hhd, Ce, Ke, Ce, Hhd, Gd, Md, Rd, Rd, Hhd, Md, Hhd, Hhd, Hhd, Hhd, Hhd, Hh, Hh, Md, Md, Gg, Gg, Gg
Gd, Gd, Gd, Gd, Gd, Gd, Gd, Gd, Gd, Gd, Gd, Gd, Gd, Gd, Gd, Gd, Gd, Gd, Gd, Gd, Gd, Gd, Gd, Gd, Gd, Gd, Gd, Gd, Gd, Gd, Gd, Gd, Gd, Gd, Gd, Gd, Md, Md, Md, Md, Md, Md, Md, Md, Md, Md, Rd, Md, Gd, Gd, Rd, Gd, Rd, Gd, Rd, Rd, Hhd, Gd, Gd, Md, Md, Hhd, Hh, Hh, Hh, Hh, Mm, Hh, Md, Gg, Gg, Gg
Gd, Gd, Gd, Gd, Gd, Gd, Gd, Gd, Gd, Gd, Gd, Gd, Gd, Gd, Gd, Gd, Gd, Gd, Gd, Gd, Gd, Gd, Gd, Gd, Gd, Gd, Gd, Gd, Gd, Gd, Gd, Gd, Gd, Gd, Gd, Gd, Md, Md, Md, Md, Md, Md, Hhd, Hhd, Md, Md, Md, Rd, Rd, Rd, Gd, Rd, Gd, Rd, Rd, Gd, Gd, Hhd, Hhd, Hhd, Md, Hh, Md, Hh, Mm, Mm, Mm, Mm, Ww, Gg, Gg, Gg
Gd, Gd, Gd, Gd, Gd, Gd, Gd, Gd, Gd, Gd, Gd, Gd, Gd, Gd, Gd, Gd, Gd, Gd, Gd, Gd, Gd, Gd, Gd, Gd, Gd, Gd, Gd, Gd, Gd, Gd, Gd, Gd, Gd, Gd, Gd, Gd, Md, Hhd, Gd, Md, Md, Md, Hhd, Md, Md, Md, Md, Md, Rd, Gd, Gd, Gd, Gd, Gd, Rd, Gd, Hhd, Hhd, Gd, Hhd, Md, Hh, Hh, Mm, Mm, Hh^Fp, Ww, Ww, Gg^Efm, Gg, Gg, Gg
Gd, Gd, Gd, Gd, Gd, Gd, Gd, Gd, Gd, Gd, Gd, Gd, Gd, Gd, Gd, Gd, Gd, Gd, Gd, Gd, Gd, Gd, Gd, Gd, Gd, Gd, Gd, Gd, Gd, Gd, Gd, Gd, Gd, Gd, Gd, Gd, Mv, Md, Md, Hhd, Md, Md, Md, Hhd, Hhd, Md, Ce, Rd, Rd, Gd, Gd, Gd, Gd, Gd, Rd, Gd, Hhd, Hhd, Md, Md, Gg, Hh, Hh, Mm, Mm, Mm, Mm, Mm, Ms, Gg, Gg, Gg
Gd, Gd, Gd, Gd, Gd, Gd, Gd, Gd, Gd, Gd, Gd, Gd, Gd, Gd, Gd, Gd, Gd, Gd, Gd, Gd, Gd, Gd, Gd, Gd, Gd, Gd, Gd, Gd, Gd, Gd, Gd, Gd, Gd, Gd, Gd, Gd, Md, Md, Md, Md, Md, Md, Md, Hhd, Gd, Ke, Ce, Gd, Rd, Gd, Gd^Es, Gd, Gd, Gd, Rd, Gd, Gd^Es, Md, Md, Hh, Hh, Gg, Hh, Wo, Mm, Gg^Efm, Gg, Ms, Ms, Gg, Gg, Gg
Gd, Gd, Gd, Gd, Gd, Gd, Gd, Gd, Gd, Gd, Gd, Gd, Gd, Gd, Gd, Gd, Gd, Gd, Gd, Gd, Gd, Gd, Gd, Gd, Gd, Gd, Gd, Gd, Gd, Gd, Gd, Gd, Gd, Gd, Gd, Gd, Md, Md, Md, Md, Md, Md, Gd^Vo, Hhd, Hhd, Hhd, Hhd, Ce, Gd, Rd, Rd, Gd, Rd, Gd, Rd, Gd, Gd, Gd^Vhr, Hhd, Md, Mm, Mm, Mm, Hh, Hh^Fp, Hh, Ms, Ms, Mm, Gg, Gg, Gg
Gd, Gd, Gd, Gd, Gd, Gd, Gd, Gd, Gd, Gd, Gd, Gd, Gd, Gd, Gd, Gd, Gd, Gd, Gd, Gd, Gd, Gd, Gd, Gd, Gd, Gd, Gd, Gd, Gd, Gd, Gd, Gd, Gd, Gd, Gd, Gd, Md, Md, Md, Md, Hhd, Md, Md, Hhd, Gd, Gd, Hhd, Hhd, Rd, Rd, Rd, Rd, Hhd, Rd, Rd, Gd, Gd, Gd, Gs, Gd, Hh, Hh, Ms, Ms, Ms, Gg^Efm, Ms, Mm, Mm, Gg, Gg, Gg
Gd, Gd, Gd, Gd, Gd, Gd, Gd, Gd, Gd, Gd, Gd, Gd, Gd, Gd, Gd, Gd, Gd, Gd, Gd, Gd, Gd, Gd, Gd, Gd, Gd, Gd, Gd, Gd, Gd, Gd, Gd, Gd, Gd, Gd, Gd, Gd, Md, Hhd, Md, Md, Hhd, Hhd, Md, Hhd, Hhd, Gd, Hhd, Rd, Gd, Gd, Gd, Gd, Md, Hhd, Hhd, Rd, Gd, Gd, Gd, Gs, Gd, Hh, Ms, Ww, Ha, Ms, Ms, Ms, Mm, Gg, Gg, Gg
Gd, Gd, Gd, Gd, Gd, Gd, Gd, Gd, Gd, Gd, Gd, Gd, Gd, Gd, Gd, Gd, Gd, Gd, Gd, Gd, Gd, Gd, Gd, Gd, Gd, Gd, Gd, Gd, Gd, Gd, Gd, Gd, Gd, Gd, Gd, Gd, Md, Hhd, Hhd, Md, Hhd, Md, Hhd, Md, Rd, Rd, Rd, Rd, Hhd, Hhd, Hhd, Gd, Md, Hhd, Hhd, Rd, Gd, Gs, Gs, Hh, Gs, Hh, Hh, Ww, Wo, Ms, Ms, Mm, Mm, Gg, Gg, Gg
Gd, Gd, Gd, Gd, Gd, Gd, Gd, Gd, Gd, Gd, Gd, Gd, Gd, Gd, Gd, Gd, Gd, Gd, Gd, Gd, Gd, Gd, Gd, Gd, Gd, Gd, Gd, Gd, Gd, Gd, Gd, Gd, Gd, Gd, Gd, Gd, Md, Hhd, Md, Md, Md, Md, Rd, Rd, Md, Md, Md, Hhd, Hhd, Hhd, Md, Md, Hhd, Hhd, Gd, Rd, Gd, Gs, Gd, Gd, Gs, Hh, Gg, Ww, Hh, Ms, Hh, Ms, Ms, Gg, Gg, Gg
Gd, Gd, Gd, Gd, Gd, Gd, Gd, Gd, Gd, Gd, Gd, Gd, Gd, Gd, Gd, Gd, Gd, Gd, Gd, Gd, Gd, Gd, Gd, Gd, Gd, Gd, Gd, Gd, Gd, Gd, Gd, Gd, Gd, Gd, Gd, Gd, Hhd, Gd^Fdw, Md, Hhd, Hhd, Md, Rd, Hhd, Hhd, Md, Md, Hhd, Md, Gd, Md, Hhd, Gd, Gd, Gd, Rd, Rd, Gd, Gd, Gs, Hh, Gg, Gg, Ww, Ww, Hh, Hh, Hh^Fp, Ms, Gg, Gg, Gg
Gd, Gd, Gd, Gd, Gd, Gd, Gd, Gd, Gd, Gd, Gd, Gd, Gd, Gd, Gd, Gd, Gd, Gd, Gd, Gd, Gd, Gd, Gd, Gd, Gd, Gd, Gd, Gd, Gd, Gd, Gd, Gd, Gd, Gd, Gd, Gd, Hhd, Md, Md, Hhd, Rd, Rd, Gd^Fdw, Hhd, Gd, Md, Md, Md, Md, Hhd, Md, Gd^Fdw, Hhd, Gd, Gd, Rd, Gd, Rd, Rd, Gd, Gd, Gg, Gg, Gg, Gs, Ww, Ww, Ms, Gs, Gg, Gg, Gg
Gd, Gd, Gd, Gd, Gd, Gd, Gd, Gd, Gd, Gd, Gd, Gd, Gd, Gd, Gd, Gd, Gd, Gd, Gd, Gd, Gd, Gd, Gd, Gd, Gd, Gd, Gd, Gd, Gd, Gd, Gd, Gd, Gd, Gd, Gd, Gd, Gd^Fdw, Md, Md, Hhd, Rd, Hhd, Gd^Fdw, Gd^Es, Md, Md, Md, Md, Md, Md, Md, Md, Gd^Fdw, Gd, Gd, Rd, Gd, Gd, Gd, Rd, Rd, Gs, Gs, Gs, Gg, Hh, Ww, Hh, Gs, Gg, Gg, Gg
Gd, Gd, Gd, Gd, Gd, Gd, Gd, Gd, Gd, Gd, Gd, Gd, Gd, Gd, Gd, Gd, Gd, Gd, Gd, Gd, Gd, Gd, Gd, Gd, Gd, Gd, Gd, Gd, Gd, Gd, Gd, Gd, Gd, Gd, Gd, Gd, Gd^Vo, Hhd, Hhd, Md, Rd, Md, Md, Md, Md, Md, Md, Md, Md, Md, Gd, Hhd, Gd, Gd, Rd, Rd, Gd, Gd, Gd, Hhd, Rd, Mm, Hh, Gs, Gs, Gg, Gg, Ww, Ww, Gg, Gg, Gg
Gd, Gd, Gd, Gd, Gd, Gd, Gd, Gd, Gd, Gd, Gd, Gd, Gd, Gd, Gd, Gd, Gd, Gd, Gd, Gd, Gd, Gd, Gd, Gd, Gd, Gd, Gd, Gd, Gd, Gd, Gd, Gd, Gd, Gd, Gd, Gd, Hhd, Md, Rd, Rd, Hhd, Md, Md, Md, Hhd, Md, Md, Md, Md, Md, Hhd, Hhd, Gd, Gd, Rd, Gd, Hhd, Hhd, Hhd, Hhd, Rd, Mm, Md, Gs, Hh, Gg, Gg, Gg, Gg, Gg, Gg, Gg
Gd, Gd, Gd, Gd, Gd, Gd, Gd, Gd, Gd, Gd, Gd, Gd, Gd, Gd, Gd, Gd, Gd, Gd, Gd, Gd, Gd, Gd, Gd, Gd, Gd, Gd, Gd, Gd, Gd, Gd, Gd, Gd, Gd, Gd, Gd, Gd, Rd, Rd, Md, Md, Md, Md, Md, Md, Md, Md, Gd, Md, Md, Hhd, Hhd, Gd^Fdw, Gd^Dr, Rd, Hhd, Gd^Fdw, Md, Md, Md, Hhd, Md, Rd, Rd, Md, Md, Hh, Gg, Gg, Gs, Gg, Gg, Gg
Gd, Gd, Gd, Gd, Gd, Gd, Gd, Gd, Gd, Gd, Gd, Gd, Gd, Gd, Gd, Gd, Gd, Gd, Gd, Gd, Gd, Gd, Gd, Gd, Gd, Gd, Gd, Gd, Gd, Gd, Gd, Gd, Gd, Gd, Gd, Gd, Mm, Hhd, Hhd, Gd^Fdw, Hhd, Md, Hhd, Md, Hhd, Hhd, Hhd, Hhd, Hhd, Gd, Hhd, Hhd, Rd, Rd, Hhd, Md, Md, Md, Md, Md, Hhd, Md, Rd, Md, Mm, Gs^Fms, Gg, Gs, Gs, Gg, Gg, Gg
Gd, Gd, Gd, Gd, Gd, Gd, Gd, Gd, Gd, Gd, Gd, Gd, Gd, Gd, Gd, Gd, Gd, Gd, Gd, Gd, Gd, Gd, Gd, Gd, Gd, Gd, Gd, Gd, Gd, Gd, Gd, Gd, Gd, Gd, Gd, Gd, Md, Mm, Md, Mm, Mm, Mm, Hhd, Hhd, Gd^Fdw, Hhd, Gd^Fdw, Mm, Hhd, Hhd, Rd, Rd, Rd, Hhd, Gd, Hhd, Gd^Fdw, Md, Gd^Fdw, Hhd, Gd, Hhd, Rd, Hhd, Hhd, Mm, Mm, Gs, Gg, Gg, Gg, Gg
Gd, Gd, Gd, Gd, Gd, Gd, Gd, Gd, Gd, Gd, Gd, Gd, Gd, Gd, Gd, Gd, Gd, Gd, Gd, Gd, Gd, Gd, Gd, Gd, Gd, Gd, Gd, Gd, Gd, Gd, Gd, Gd, Gd, Gd, Gd, Gd, Rd, Md, Md, Md^Xm, Md^Xm, Md^Xm, Gd, Gd^Vo, Gd, Hhd, Gd, Gd^Fdw, Rd, Rd, Rd, Rd, Hhd, Gd^Vhr, Gd, Gd^Fdw, Gd, Md, Hhd, Gd, Gd^Fdw, Gd^Fdw, Rd, Hhd, Hhd, Md, Mm, Mm, Mm, Gg, Gg, Gg
Gd, Gd, Gd, Gd, Gd, Gd, Gd, Gd, Gd, Gd, Gd, Gd, Gd, Gd, Gd, Gd, Gd, Gd, Gd, Gd, Gd, Gd, Gd, Gd, Gd, Gd, Gd, Gd, Gd, Gd, Gd, Gd, Gd, Gd, Gd, Gd, Hhd, Rd, Gd^Fdw, Hhd, Gd^Fdw, Md, Gd, Gd, Gd, Gd, Rd, Rd, Rd, Ce, Ke, Ce, Gd, Gd, Gd, Gd, Gd, Gd^Fdw, Gd, Gd, Gd, Gd^Fdw, Rd, Hhd, Hhd, Md, Mm, Mm, Mm, Gg, Gg, Gg
Gd, Gd, Gd, Gd, Gd, Gd, Gd, Gd, Gd, Gd, Gd, Gd, Gd, Gd, Gd, Gd, Gd, Gd, Gd, Gd, Gd, Gd, Gd, Gd, Gd, Gd, Gd, Gd, Gd, Gd, Gd, Gd, Gd, Gd, Gd, Gd, Gd, Rd, Rd, Gd^Fdw, Gd, Gd^Dr, Gd, Gd, Gd^Fdw, Md, Rd, Rd, Ce, Ke, Ce, Ce, Gd, Gd, Gd, Gd, Gd, Gd, Gd, Hhd, Gd^Fdw, Rd, Rd, Gd^Fetd, Rd, Md, Mm, Mm, Mm, Gg, Gg, Gg
Gd, Gd, Gd, Gd, Gd, Gd, Gd, Gd, Gd, Gd, Gd, Gd, Gd, Gd, Gd, Gd, Gd, Gd, Gd, Gd, Gd, Gd, Gd, Gd, Gd, Gd, Gd, Gd, Gd, Gd, Gd, Gd, Gd, Gd, Gd, Gd, Rd, Rd, Gd, Gd^Vo, Gd, Gd, Gd, Gd^Vhr, Gd, Rd, Gd, Gd, Gd, Rd, Rd, Rd, Gd, Gd^Fdw, Hhd, Md, Gd^Fdw, Gd, Gd, Gd^Vhr, Rd, Rd, Gd, Rd, Rd, Rd, Gg, Mm, Gg, Gg, Gg, Gg
Gd, Gd, Gd, Gd, Gd, Gd, Gd, Gd, Gd, Gd, Gd, Gd, Gd, Gd, Gd, Gd, Gd, Gd, Gd, Gd, Gd, Gd, Gd, Gd, Gd, Gd, Gd, Gd, Gd, Gd, Gd, Gd, Gd, Gd, Gd, Gd, Gd^Fdw, Hhd, Gd^Fdw, Gd, Gd, Gd, Rd, Gd, Rd, Rd, Md^Xm, Gd^Fdw, Md^Xm, Gd, Rd, Rd, Gd, Gd, Gd, Gd^Fdw, Hhd, Gd^Fdw, Rd, Rd, Rd, Gd, Gd, Gd, Gd^Fdw, Md^Xm, Gg, Gg, Gg, Gg, Gg, Gg
Gd, Gd, Gd, Gd, Gd, Gd, Gd, Gd, Gd, Gd, Gd, Gd, Gd, Gd, Gd, Gd, Gd, Gd, Gd, Gd, Gd, Gd, Gd, Gd, Gd, Gd, Gd, Gd, Gd, Gd, Gd, Gd, Gd, Gd, Gd, Gd, Md, Md^Xm, Md^Xm, Md, Rd, Rd, Gd, Rd, Gd, Gd^Fdw, Gd^Fdw, Md^Xm, Md^Xm, Hhd, Rd, Gd, Gd, Gd^Es, Gd, Gd^Vhr, Gd, Gd, Rd, Rd, Gd^Es, Gd, Gd^Fdw, Hhd, Md^Xm, Md^Xm, Gg, Gg, Gg, Gg, Gg, Gg
Gd, Gd, Gd, Gd, Gd, Gd, Gd, Gd, Gd, Gd, Gd, Gd, Gd, Gd, Gd, Gd, Gd, Gd, Gd, Gd, Gd, Gd, Gd, Gd, Gd, Gd, Gd, Gd, Gd, Gd, Gd, Gd, Gd, Gd, Gd, Gd, Gd^Fdw, Gd^Fdw, Gd, Hhd, Rd, Gd, Gd^Vhr, Gd, Gd, Mm, Md^Xm, Gd^Fdw, Gd^Fdw, Hhd, Rd, Gd, Hhd, Gd, Gd^Fetd, Gd, Gd, Rd, Rd, Gd, Gd, Gd, Hhd, Md^Xm, Md^Xm, Md, Gg, Gg, Gg, Gg, Gg, Gg
Gd, Gd, Gd, Gd, Gd, Gd, Gd, Gd, Gd, Gd, Gd, Gd, Gd, Gd, Gd, Gd, Gd, Gd, Gd, Gd, Gd, Gd, Gd, Gd, Gd, Gd, Gd, Gd, Gd, Gd, Gd, Gd, Gd, Gd, Gd, Gd, Rd, Gd, Rd, Rd, Gd, Gd^Fdw, Gd, Gd, Gd^Es, Hhd, Md^Xm, Gd^Fdw, Hhd, Hhd^Vhhr, Rd, Hhd, Gd^Fdw, Md, Hhd, Gd, Rd, Rd, Ce, Gd, Hhd, Gd, Gd, Md, Md^Xm, Md, Gg, Gg, Gg, Gg, Gg, Gg
Gd, Gd, Gd, Gd, Gd, Gd, Gd, Gd, Gd, Gd, Gd, Gd, Gd, Gd, Gd, Gd, Gd, Gd, Gd, Gd, Gd, Gd, Gd, Gd, Gd, Gd, Gd, Gd, Gd, Gd, Gd, Gd, Gd, Gd, Gd, Gd, Rd, Rd, Md, Gd, Gd, Gd, Gd^Es, Gd, Gd, Gd^Fdw, Md^Xm, Md^Xm, Gd^Fdw, Gd, Gd, Rd, Rd, Hhd, Rd, Rd, Hhd, Rd, Ce, Ce, Gd^Fetd, Gd, Gd^Es, Hhd, Gd^Fdw, Md^Xm, Gg, Gg, Gg, Gg, Gg, Gg
Gd, Gd, Gd, Gd, Gd, Gd, Gd, Gd, Gd, Gd, Gd, Gd, Gd, Gd, Gd, Gd, Gd, Gd, Gd, Gd, Gd, Gd, Gd, Gd, Gd, Gd, Gd, Gd, Gd, Gd, Gd, Gd, Gd, Gd, Gd, Gd, Rd, Gd^Fdw, Hhd, Gd^Fdw, Rd, Rd, Gd, Gd, Gd^Fdw, Md^Xm, Md^Xm, Mm, Gd, Gd, Rd, Rd, Gd, Rd, Gd, Md^Xm, Md, Gd, Rd, Rd, Rd, Rd, Rd, Gd, Gd, Gd^Fdw, Gg, Gg, Gg, Gg, Gg, Gg
Gd, Gd, Gd, Gd, Gd, Gd, Gd, Gd, Gd, Gd, Gd, Gd, Gd, Gd, Gd, Gd, Gd, Gd, Gd, Gd, Gd, Gd, Gd, Gd, Gd, Gd, Gd, Gd, Gd, Gd, Gd, Gd, Gd, Gd, Gd, Gd, Gd, Rd, Rd, Rd, Rd, Rd, Rd, Gd, Mm, Md^Xm, Gll^Dr, Hhd, Gd, Gd, Rd, Gd, Gd, Hhd, Md^Xm, Md^Xm, Gd^Fdw, Gd, Gd, Rd, Rd, Rd, Hhd, Rd, Rd, Rd, Gg, Gg, Gg, Gg, Gg, Gg
Gd, Gd, Gd, Gd, Gd, Gd, Gd, Gd, Gd, Gd, Gd, Gd, Gd, Gd, Gd, Gd, Gd, Gd, Gd, Gd, Gd, Gd, Gd, Gd, Gd, Gd, Gd, Gd, Gd, Gd, Gd, Gd, Gd, Gd, Gd, Gd, Gd^Fdw, Gd, Gd, Rd, Gd^Fdw, Rd, Ce, Gd, Hhd, Md^Xm, Rd, Rd, Rd, Rd, Gd, Gd, Gd^Fdw, Md, Md^Xm, Md^Xm, Gd, Gd, Gd, Rd, Gd, Gd^Fdw, Mm, Gd^Fdw, Rd, Hhd, Gg, Gg, Gg, Gg, Gg, Gg
Gd, Gd, Gd, Gd, Gd, Gd, Gd, Gd, Gd, Gd, Gd, Gd, Gd, Gd, Gd, Gd, Gd, Gd, Gd, Gd, Gd, Gd, Gd, Gd, Gd, Gd, Gd, Gd, Gd, Gd, Gd, Gd, Gd, Gd, Gd, Gd, Md^Xm, Hhd, Gd, Gd, Hhd, Ce, Ce, Rd, Rd, Rd, Hhd, Hhd, Gd^Fetd, Rd, Rd, Gd, Hhd, Md^Xm, Md^Xm, Gd^Fdw, Gd, Gd^Es, Gd, Gd, Gd, Gd, Rd, Rd, Rd, Gd^Fdw, Gg, Gg, Gg, Gg, Gg, Gg
Gd, Gd, Gd, Gd, Gd, Gd, Gd, Gd, Gd, Gd, Gd, Gd, Gd, Gd, Gd, Gd, Gd, Gd, Gd, Gd, Gd, Gd, Gd, Gd, Gd, Gd, Gd, Gd, Gd, Gd, Gd, Gd, Gd, Gd, Gd, Gd, Md^Xm, Md, Hhd, Gd, Gd, Gd, Rd, Rd, Gd, Gd, Gd^Fdw, Md, Hhd, Hhd, Rd, Gd^Vo, Gd^Fdw, Gd^Fdw, Md^Xm, Hhd, Gd, Gd, Gd^Vo, Gd^Fdw, Rd, Rd, Gd, Gd, Gd^Fetd, Rd, Gg, Gg, Gg, Gg, Gg, Gg
Gd, Gd, Gd, Gd, Gd, Gd, Gd, Gd, Gd, Gd, Gd, Gd, Gd, Gd, Gd, Gd, Gd, Gd, Gd, Gd, Gd, Gd, Gd, Gd, Gd, Gd, Gd, Gd, Gd, Gd, Gd, Gd, Gd, Gd, Gd, Gd, Md^Xm, Md^Xm, Gd^Fdw, Gd, Gd, Gd, Rd, Rd, Gd, Gd, Gd, Gd, Gd, Gd, Rd, Hhd, Md^Xm, Gd^Fdw, Gd^Fdw, Md, Gd, Gd, Gd, Gd, Rd, Hhd, Md^Xm, Gd^Fdw, Md, Rd, Gg, Gg, Gg, Gg, Gg, Gg
Gd, Gd, Gd, Gd, Gd, Gd, Gd, Gd, Gd, Gd, Gd, Gd, Gd, Gd, Gd, Gd, Gd, Gd, Gd, Gd, Gd, Gd, Gd, Gd, Gd, Gd, Gd, Gd, Gd, Gd, Gd, Gd, Gd, Gd, Gd, Gd, Gd^Fdw, Hhd, Gd, Gd, Rd, Rd, Rd, Gd, Hhd, Gd^Vo, Gd, Gd, Gd^Es, Gd, Rd, Hhd, Md^Xm, Md^Xm, Md^Xm, Gd^Fdw, Rd, Rd, Rd, Rd, Gd, Md, Gd^Fdw, Md^Xm, Gd^Fdw, Rd, Gd, Gd, Gd, Gd, Hhd, Hhd
Gd, Gd, Gd, Gd, Gd, Gd, Gd, Gd, Gd, Gd, Gd, Gd, Gd, Gd, Gd, Gd, Gd, Gd, Gd, Gd, Gd, Gd, Gd, Gd, Gd, Gd, Gd, Gd, Gd, Gd, Gd, Gd, Gd, Gd, Gd, Gd, Rd, Gd^Es, Gd, Gd, Rd, Rd, Gd, Gd^Fdw, Gd^Fdw, Gd^Fdw, Hhd, Gd, Gd, Rd, Rd, Gd, Gd, Gd^Fdw, Gd, Rd, Gd, Gd, Gd, Gd, Gd, Gd, Gd, Hhd, Rd, Rd, Hhd, Hhd, Hhd, Gd, Hhd, Hhd
Gd, Gd, Gd, Gd, Gd, Gd, Gd, Gd, Gd, Gd, Gd, Gd, Gd, Gd, Gd, Gd, Gd, Gd, Gd, Gd, Gd, Gd, Gd, Gd, Gd, Gd, Gd, Gd, Gd, Gd, Gd, Gd, Gd, Gd, Gd, Gd, Rd, Rd, Rd, Rd, Gd^Fdw, Gd^Vo, Gd, Gd, Gd, Mm, Gd, Gd^Fdw, Gd, Rd, Co, Rd, Co, Gd, Rd, Rd, Gd^Fdw, Gd^Vo, Gd, Gd, Gd, Gd^Vo, Rd, Rd, Gd, Gd, Gd, Gd, Gd, Hhd, Hhd, Hhd
Gd, Gd, Gd, Gd, Gd, Gd, Gd, Gd, Gd, Gd, Gd, Gd, Gd, Gd, Gd, Gd, Gd, Gd, Gd, Gd, Gd, Gd, Gd, Gd, Gd, Gd, Gd, Gd, Gd, Gd, Gd, Gd, Gd, Gd, Gd, Gd, Md, Gd^Fdw, Rd, Rd, Gd^Efm, Hhd, Gd, Gd, Gd, Gd, Gd, Gd, Gd, Co, 1 Ko, Ko, Rd, Rd, Rd, Md, Gd, Gd^Es, Gd, Gd^Dr, Gd^Fdw, Gd^Fdw, Gd^Fdw, Rd, Hhd, Gd^Fdw, Hhd, Gd, Hhd, Hhd, Mm, Mm
Gd, Gd, Gd, Gd, Gd, Gd, Gd, Gd, Gd, Gd, Gd, Gd, Gd, Gd, Gd, Gd, Gd, Gd, Gd, Gd, Gd, Gd, Gd, Gd, Gd, Gd, Gd, Gd, Gd, Gd, Gd, Gd, Gd, Gd, Gd, Gd, Hhd, Hhd, Rd, Gd^Fdw, Gd^Fdw, Gd, Hhd, Gd^Fdw, Gd, Gd^Es, Gd, Gd, Hhd, Co, Rd, Co, Rd, Rd, Gd, Gd, Gd, Gd, Gd, Gd^Fdw, Md^Xm, Hhd, Md, Rd, Md, Md, Md, Md, Mm, Hhd, Mm, Mm
Gd, Gd, Gd, Gd, Gd, Gd, Gd, Gd, Gd, Gd, Gd, Gd, Gd, Gd, Gd, Gd, Gd, Gd, Gd, Gd, Gd, Gd, Gd, Gd, Gd, Gd, Gd, Gd, Gd, Gd, Gd, Gd, Gd, Gd, Gd, Gd, Hhd, Rd, Gd, Gd^Fdw, Gd^Fdw, Gd, Hhd, Md, Gd^Fdw, Gd^Fdw, Gd, Gd^Vo, Rd, Rd, Rd, Rd, Gd^Fdw, Hhd, Gd^Fdw, Gd, Gd^Fetd, Gd^Vo, Hhd, Md^Xm, Md, Md^Xm, Md, Rd, Rd, Md, Mm, Mm, Mm, Mm, Mm, Mm
Gd, Gd, Gd, Gd, Gd, Gd, Gd, Gd, Gd, Gd, Gd, Gd, Gd, Gd, Gd, Gd, Gd, Gd, Gd, Gd, Gd, Gd, Gd, Gd, Gd, Gd, Gd, Gd, Gd, Gd, Gd, Gd, Gd, Gd, Gd, Gd, Rd, Rd, Gd, Gd, Gd, Md, Gd, Gd^Fdw, Gd^Fdw, Gd, Gd, Rd, Rd, Rd, Gd, Md, Gd, Gd^Fdw, Gd, Gd^Fdw, Gd, Hhd, Hhd, Md^Xm, Hhd, Md, Md, Md, Mm, Md, Hh, Mm, Hh, Mm, Hh, Gs
Gd, Gd, Gd, Gd, Gd, Gd, Gd, Gd, Gd, Gd, Gd, Gd, Gd, Gd, Gd, Gd, Gd, Gd, Gd, Gd, Gd, Gd, Gd, Gd, Gd, Gd, Gd, Gd, Gd, Gd, Gd, Gd, Gd, Gd, Gd, Gd, Gd, Gd, Md, Hhd, Hhd, Gd^Fdw, Hhd, Gd^Fdw, Gd, Mm, Rd, Rd, Rd, Gd, Gd, Mm, Gd^Fdw, Gd, Hhd, Gd, Hhd, Gd, Hhd, Hhd, Md, Md, Mm, Mm, Mm, Mm, Hh, Re, Re, Mm, Gs, Hh
Gd, Gd, Gd, Gd, Gd, Gd, Gd, Gd, Gd, Gd, Gd, Gd, Gd, Gd, Gd, Gd, Gd, Gd, Gd, Gd, Gd, Gd, Gd, Gd, Gd, Gd, Gd, Gd, Gd, Gd, Gd, Gd, Gd, Gd, Gd, Gd, Gd, Gd^Fdw, Md, Gd^Fdw, Hhd, Gd, Gd, Gd, Gd, Gd, Rd, Gd, Gd, Rd, Rd, Gd, Gd, Gd, Hhd, Hhd, Mm, Hhd, Hh, Md, Mm, Mm, Mm, Mm, Mm, Mm, Hh, Gs, Gs, Re, Rb, Gs
Gd, Gd, Gd, Gd, Gd, Gd, Gd, Gd, Gd, Gd, Gd, Gd, Gd, Gd, Gd, Gd, Gd, Gd, Gd, Gd, Gd, Gd, Gd, Gd, Gd, Gd, Gd, Gd, Gd, Gd, Gd, Gd, Gd, Gd, Gd, Gd, Hhd, Hhd, Gd^Fdw, Hhd, Gd, Gd, Gd^Fdw, Gd, Rd, Rd, Gd, Gd, Gd^Vo, Gd, Rd, Gd, Hhd, Gd^Fdw, Hhd, Hhd, Md, Md, Mm, Mm, Gs, Hh, Mm, Mm, Hh^Fp, Hh, Gs, Gs, Rb, Rb, Gg, Rb
Gd, Gd, Gd, Gd, Gd, Gd, Gd, Gd, Gd, Gd, Gd, Gd, Gd, Gd, Gd, Gd, Gd, Gd, Gd, Gd, Gd, Gd, Gd, Gd, Gd, Gd, Gd, Gd, Gd, Gd, Gd, Gd, Gd, Gd, Gd, Gd, Gd^Fdw, Hhd, Gd^Vo, Gd^Fdw, Gd, Gd, Rd, Rd, Gd, Gd, Gd, Gd^Fdw, Gd, Hhd, Gd, Rd, Hhd, Gd, Mm, Md, Mm, Mm, Mm, Mm, Mm, Mm, Hh, Gg, Hh, Hh, Re, Rb, Ss, Ss, Ss, Ss
Gd, Gd, Gd, Gd, Gd, Gd, Gd, Gd, Gd, Gd, Gd, Gd, Gd, Gd, Gd, Gd, Gd, Gd, Gd, Gd, Gd, Gd, Gd, Gd, Gd, Gd, Gd, Gd, Gd, Gd, Gd, Gd, Gd, Gd, Gd, Gd, Gd, Hhd, Hhd, Gd, Rd, Rd, Hhd, Hhd, Hhd, Gd^Fdw, Gd, Hhd, Gd, Hhd, Md, Rd, Md, Md, Mm, Mm, Mm, Mm, Mm, Mm, Mm, Hh, Hh, Gg, Gs, Gs, Rb, Ss, Ss, Ss, Ss, Ss
Gd, Gd, Gd, Gd, Gd, Gd, Gd, Gd, Gd, Gd, Gd, Gd, Gd, Gd, Gd, Gd, Gd, Gd, Gd, Gd, Gd, Gd, Gd, Gd, Gd, Gd, Gd, Gd, Gd, Gd, Gd, Gd, Gd, Gd, Gd, Gd, Gd, Gd, Rd, Rd, Gd, Gd, Hhd, Md, Md, Hhd, Hhd, Hhd, Md, Md, Mm, Hhd, Mm, Md, Mm, Hh, Mm, Hh, Hh, Mm, Mm, Hh, Gs, Hh, Gs, Gg, Sm, Ss, Ss, Gg, Ss, Gg
Gd, Gd, Gd, Gd, Gd, Gd, Gd, Gd, Gd, Gd, Gd, Gd, Gd, Gd, Gd, Gd, Gd, Gd, Gd, Gd, Gd, Gd, Gd, Gd, Gd, Gd, Gd, Gd, Gd, Gd, Gd, Gd, Gd, Gd, Gd, Gd, Rd, Rd, Gd, Hhd, Gd, Hhd, Hhd, Md, Hhd, Hhd, Mm, Mm, Hhd, Mm, Hh, Hh, Mm, Hh^Vhh, Mm, Mm, Hh, Gs, Gs, Hh, Gs, Hh, Gs, Gs, Ss, Ss, Ss, Ss, Gg, Ss, Gg, Ww
Gd, Gd, Gd, Gd, Gd, Gd, Gd, Gd, Gd, Gd, Gd, Gd, Gd, Gd, Gd, Gd, Gd, Gd, Gd, Gd, Gd, Gd, Gd, Gd, Gd, Gd, Gd, Gd, Gd, Gd, Gd, Gd, Gd, Gd, Rd, Rd, Gd, Gd^Fdw, Hhd, Md, Md, Gd^Dr, Md, Md, Hhd, Gd, Mm, Mm, Mm, Mm, Mm, Hh, Re, Hh, Hh, Hh, Gs, Gs, Gg, Gs, Ss, Gs, Gg, Gg, Ss, Gg, Rb, Gg, Gg, Ss, Ww, Wo
Gd, Gd, Gd, Gd, Gd, Gd, Gd, Gd, Gd, Gd, Gd, Gd, Gd, Gd, Gd, Gd, Gd, Gd, Gd, Gd, Gd, Gd, Gd, Gd, Gd, Gd, Gd, Gd, Gd, Gd, Gd, Gd, Rd, Rd, Gd, Gd, Gd, Gd, Md, Hhd, Mm, Md, Md, Md, Hh, Mm, Gs, Mm, Mm, Mm, Mm, Hh, Re, Hh, Gs, Gs, Gg, Gg, Gg, Gg, Ss, Ss, Ss, Ss, Ss, Gg, Rb, Ss, Ss, Ww, Wo, Wo
Gd, Gd, Gd, Gd, Gd, Gd, Gd, Gd, Gd, Gd, Gd, Gd, Gd, Gd, Gd, Gd, Gd, Gd, Gd, Gd, Gd, Gd, Gd, Gd, Gd, Gd, Gd, Gd, Gd, Gd, Rd, Rd, Gd, Gd, Gd, Gd, Hhd, Hhd, Md, Mm, Gs, Hhd, Mm, Mm, Mm, Mm, Hh, Mm, Gg, Hhd^Vhhr, Hh, Hh, Re, Hh, Gs, Gg, Gg, Ss, Ss, Gs, Ss, Gg, Ss, Gg, Ss, Ss, Gg, Ss^Vhs, Ww^Bw\, Ww, Wo, Ww
Gd, Gd, Gd, Gd, Gd, Gd, Gd, Gd, Gd, Gd, Gd, Gd, Gd, Gd, Gd, Gd, Gd, Gd, Gd, Gd, Gd, Gd, Gd, Gd, Gd, Gd, Gd, Gd, Rd, Rd, Gd, Gd, Gd, Gd, Gd, Gd, Hhd, Md, Hh, Mm, Mm, Mm, Mm, Mm, Hh^Fp, Hh, Hh, Gs, Gs, Gs, Re, Re, Gg, Gs, Gg, Gs, Gg, Gg, Ss, Ss, Ss, Ss, Gg, Gg, Ss, Ss, Ss, Ss, Ww, Wo, Ww, Ss
Gd, Gd, Gd, Gd, Gd, Gd, Gd, Gd, Gd, Gd, Gd, Gd, Gd, Gd, Gd, Gd, Gd, Gd, Gd, Gd, Gd, Gd, Gd, Gd, Gd, Gd, Gd, Gd, Rd, Gd, Gd, Gd, Gd, Gd, Gd, Gd, Mm, Mm, Mm, Mm, Mm, Mm, Hh, Mm, Hh, Hh, Gs, Gs, Re, Re, Gg, Gg, Gg, Gg, Gg, Gg, Gg, Ss, Ss, Ss, Gg, Ss, Ss, Ss, Ss, Gg, Ss, Gg, Wo, Wo, Ww, Ww
Gd, Gd, Gd, Gd, Gd, Gd, Gd, Gd, Gd, Gd, Gd, Gd, Gd, Gd, Gd, Gd, Gd, Gd, Gd, Gd, Gd, Gd, Gd, Gd, Gd, Gd, Gd, Gd, Rd, Gd, Gd, Gd, Gd, Gd, Gd, Gd, Hhd, Mm, Mm, Mm, Mm, Mm, Hh, Gs, Hh, Gs, Re, Rb, Gg, Gs, Gg, Gg, Ss, Gg, Ss, Ss, Ss, Sm, Ss, Gg, Gg, Ss, Gg, Ss, Ss, Ss, Ss, Gg, Wo, Ss, Ww, Ww
Gd, Gd, Gd, Gd, Gd, Gd, Gd, Gd, Gd, Gd, Gd, Gd, Gd, Gd, Gd, Gd, Gd, Gd, Gd, Gd, Gd, Gd, Gd, Gd, Gd, Gd, Rd, Rd, Gd, Gd, Gd, Gd, Gd, Gd, Md, Md, Md, Hh, Mm, Hh^Vhh, Gs, Gs, Gg, Gg, Hh, Re, Gs, Gg, Gg, Gg, Gg, Ss, Ss, Ss, Ss^Vhs, Gg, Ss, Gg, Ss, Ss, Ss, Ss, Gg, Ss, Gg, Ww, Wo, Wo, Ss, Ss, Ww, Ss
Gd, Gd, Gd, Gd, Gd, Gd, Gd, Gd, Gd, Gd, Gd, Gd, Gd, Gd, Gd, Gd, Gd, Gd, Gd, Gd, Gd, Gd, Gd, Gd, Gd, Rd, Gd, Gd, Gd, Gd, Gd, Gd, Gd, Md, Md, Md, Md, Hh, Hh, Hh, Gs, Gs, Gs, Gs, Re, Re, Gg, Gg, Ss, Ss, Ss, Ww, Ss, Ww, Ss, Ss, Gg, Ss, Ss, Gg, Ss, Gg, Ss, Gg, Gg, Ss, Wo, Ss, Ss, Ww, Ww, Ww
Gd, Gd, Gd, Gd, Gd, Gd, Gd, Gd, Gd, Gd, Gd, Gd, Gd, Gd, Gd, Gd, Gd, Gd, Gd, Gd, Gd, Gd, Gd, Gd, Rd, Rd, Gd, Gd, Gd, Gd, Gd, Gd, Gd, Md, Md, Md, Hh, Gs, Gs, Gs, Gg, Gg, Rb, Rb, Gg, Gg, Gg, Gg, Ss, Ss, Ss, Ww, Ss, Ww, Wwf, Ss, Gg, Gg, Ss, Ss, Ss, Gg, Ss, Ss, Ss, Ss, Wo, Wwf, Ww, Wo, Gg, Ss
Gd, Gd, Gd, Gd, Gd, Gd, Gd, Gd, Gd, Gd, Gd, Gd, Gd, Gd, Gd, Gd, Gd, Gd, Gd, Gd, Gd, Gd, Gd, Gd, Rd, Gd, Gd, Gd, Gd, Gd, Gd, Gd, Md, Md, Md, Md, Gs, Gs, Gs, Gs, Rb, Rb, Gg, Ss, Gg, Ss, Ss, Ss, Gg, Ww, Ss, Gg, Ss, Wo, Ss, Ss, Ss, Ss, Ss, Gg, Ss, Ss, Ss, Gg, Ss, Ss, Ss, Wo, Ww, Ss, Ww, Ss
Gd, Gd, Gd, Gd, Gd, Gd, Gd, Gd, Gd, Gd, Gd, Gd, Gd, Gd, Gd, Gd, Gd, Gd, Gd, Gd, Gd, Gd, Gd, Gd, Rd, Gd, Gd, Gd, Gd, Gd, Gd, Md, Md, Md, Md, Gg, Gg, Gg, Rb, Rb, Gg, Ss, Gg, Gg, Gg, Ss, Gg, Ss, Ss, Ss, Ss, Ss, Gg, Ww, Ww, Wo, Ss, Gg, Ss, Ss, Ss, Ww, Wo, Wo, Wo, Wo, Wo, Wo, Gg, Ww, Ww, Ww
Gd, Gd, Gd, Gd, Gd, Gd, Gd, Gd, Gd, Gd, Gd, Gd, Gd, Gd, Gd, Gd, Gd, Gd, Gd, Gd, Gd, Gd, Rd, Rd, Gd, Gd, Gd, Gd, Gd, Gd, Gd, Md, Md, Md, Gg, Gg, Rb, Rb, Gg, Ss, Gg, Ss, Ss, Ss, Ss, Ss, Ss, Gg, Ss, Wwf, Ss, Ss, Ss, Gg, Ss, Ww, Ss, Ss, Ss, Wwf, Ss, Ss, Sm, Ss, Ss^Vhs, Ss^Bw/r, Ss, Ss, Wwf, Ss, Wo, Wo
Gd, Gd, Gd, Gd, Gd, Gd, Gd, Gd, Gd, Gd, Gd, Gd, Gd, Gd, Gd, Gd, Gd, Gd, Gd, Gd, Rd, Rd, Gd, Gd, Gd, Gd, Gd, Gd, Gd, Gd, Gd, Md, Ms^Xm, Md, Gg, Gg, Gg, Gg, Ss, Ss, Ss, Ss, Ss, Ss, Ss, Ss^Vhs, Ss, Ss, Ss, Gg, Gg, Gg, Ww, Ss, Ss, Ww, Ss, Ww, Ww, Ss, Ss, Ss, Ss, Ss, Ss, Gg, Ss, Ss, Ss, Ss, Wo, Ss
Gd, Gd, Gd, Gd, Gd, Gd, Gd, Gd, Gd, Gd, Gd, Gd, Gd, Gd, Gd, Gd, Gd, Gd, Rd, Rd, Gd, Gd, Gd, Gd, Gd, Gd, Gd, Gd, Gd, Gd, Gd, Ms^Xm, Ms^Xm, Ms^Xm, Gg, Gg, Ss, Ss, Ss, Ss, Ss, Gg, Ss, Gg, Gg, Ww, Gg, Ss, Gg, Ss, Ww, Ss, Ww, Ww, Ss, Ss, Wo, Ww, Ss^Vhs, Gg, Gg, Ss, Ss, Gg, Sm, Ss, Gg, Ss, Ss, Wo, Ww, Ww
Gd, Gd, Gd, Gd, Gd, Gd, Gd, Gd, Gd, Gd, Gd, Gd, Gd, Gd, Gd, Gd, Rd, Rd, Gd, Gd, Gd, Gd, Gd, Gd, Gd, Gd, Gd, Gd, Gd, Gd, Gd, Ms^Xm, Ms^Xm, Ms^Xm, Gg, Gg, Gg, Gg, Ss, Ss, Ss, Ss, Gg, Ss, Ss, Ww, Ss, Gg, Ss, Ww, Ss, Ss, Ss, Ss, Ss, Ss, Wo, Ss, Gg, Ww, Ss, Ss, Ss, Ss, Ss, Ss, Ss, Wwf, Wo, Wo, Gg, Ss
Gd, Gd, Gd, Gd, Gd, Gd, Gd, Gd, Gd, Gd, Gd, Gd, Gd, Gd, Gd, Rd, Gd, Gd, Gd, Gd, Gd, Gd, Gd, Gd, Gd, Gd, Gd, Gd, Gd, Gd, Gd, Md, Md, Md, Gg, Gg, Wo, Ss, Wo, Ss, Ss, Ss, Gg, Ss, Gg, Gg, Ww, Ss, Ss, Ss, Ss, Ss, Rb, Ss, Ss, Wo, Ss, Ss, Sm, Ss, Gg, Ss, Ss, Ss, Wwf, Ww, Ww, Ww, Wo, Hh, Gg, Ss
Gd, Gd, Gd, Gd, Gd, Gd, Gd, Gd, Gd, Gd, Gd, Gd, Gd, Gd, Gd, Rd, Gd, Gd, Gd, Gd, Gd, Gd, Gd, Gd, Gd, Gd, Gd, Gd, Gd, Gd, Gd, Md, Md, Md, Gg, Gg, Ss, Wo, Ss, Wo, Wo, Ww, Wo, Ss^Vhs, Gg, Ss, Gg, Ss, Rb, Ss, Wo, Ss, Ww, Rb, Ww, Ww, Ss^Vhs, Ss, Rb, Ww, Ww, Ss, Wwf, Ss, Wo, Ww, Wo, Wo, Ss, Gg, Ss, Gg
Rd, Gd, Gd, Gd, Gd, Gd, Gd, Gd, Gd, Gd, Gd, Gd, Gd, Gd, Rd, Rd, Gd, Gd, Gd, Gd, Gd, Gd, Gd, Gd, Gd, Gd, Gd, Gd, Gd, Gd, Gd, Md, Md, Md, Md, Gg, Ss, Ss, Ss, Ww, Ss, Wo, Ss, Wo, Wwf, Ss, Ss, Rb, Ss, Ss, Ww, Ww, Ss, Wwf, Ss, Ww, Ww, Wwf, Ww, Ss, Ww, Ww, Ss, Ww, Wo, Wo, Ww, Ss, Wwf, Ss, Ss^Vhs, Ss
Gd, Rd, Rd, Gd, Gd, Gd, Gd, Gd, Gd, Gd, Gd, Gd, Gd, Rd, Gd, Gd, Gd, Gd, Gd, Gd, Gd, Gd, Gd, Gd, Gd, Gd, Gd, Gd, Gd, Gd, Gd, Gd, Md, Md, Ms^Xm, Gg, Ss, Ss, Ss, Ww, Ss, Gg^Efm, Rb, Ss, Ss, Wwf, Ww, Ss, Wwf, Ss^Vhs, Wo, Ww, Ss, Ss, Gg, Ss, Wwf, Ss, Gg^Efm, Wo, Ww, Ss, Ss^Vhs, Ww^Bw/r, Ww, Wo, Wo, Ww, Ss, Ww, Ss, Ss
Gd, Gd, Rd, Gd, Gd, Gd, Gd, Gd, Gd, Gd, Gd, Gd, Rd, Rd, Gd, Gd, Gd, Gd, Gd, Gd, Gd, Gd, Gd, Gd, Gd, Gd, Gd, Gd, Gd, Gd, Gd, Gd, Gd, Ms^Xm, Ms^Xm, Ms^Xm, Ss, Ww, Gg, Ww, Ss, Ss, Ss, Ss, Wo, Wo, Ww, Ww, Ss, Ww, Ww, Ss, Ss, Sm, Wo, Ss, Gg^Em, Ss, Gg, Wo, Wo, Gg, Gg, Gg, Ss, Ww, Ww, Ss, Ss, Sm, Gg, Ss
Gd, Gd, Gd, Rd, Rd, Gd, Gd, Gd, Gd, Gd, Rd, Rd, Gd, Gd, Gd, Gd, Gd, Gd, Gd, Gd, Gd, Gd, Gd, Gd, Gd, Gd, Gd, Gd, Gd, Gd, Gd, Gd, Gd, Ms^Xm, Ms^Xm, Ms^Xm, Md, Gg, Rb, Rb, Ss, Ss, Ww, Wwf, Ss, Ss, Sm, Ss^Vhs, Ss, Ww, Ss, Ww, Ss, Ww, Ss, Ss, Ss, Ss, Ss, Ww, Ww, Ss, Ss, Ss, Ss, Ww, Ww, Gg, Ss, Ss, Hh, Ss
Gd, Gd, Gd, Gd, Gd, Rd, Rd, Gd, Gd, Rd, Gd, Gd, Gd, Gd, Gd, Gd, Gd, Gd, Gd, Gd, Gd, Gd, Gd, Gd, Gd, Gd, Gd, Gd, Gd, Gd, Gd, Gd, Gd, Gd, Md, Md, Md, Md, Mm, Ss, Ss, Ss, Ww, Gg, Ss, Ss, Ss, Gg, Ss, Ss, Ss, Ww, Wwf, Ss, Ss, Ss, Gg^Efm, Ss, Sm, Ww, Ss, Ww, Wwf, Ss, Ww, Ww, Wo, Ss, Ss, Hh, Mm, Hh
Gd, Gd, Gd, Gd, Gd, Gd, Gd, Rd, Rd, Rd, Gd, Gd, Gd, Gd, Gd, Gd, Gd, Gd, Gd, Gd, Gd, Gd, Gd, Gd, Gd, Gd, Gd, Gd, Gd, Gd, Gd, Gd, Gd, Gd, Gd, Md, Md, Md, Mm, Hh, Ss, Wo, Hh, Ss, Ss, Gg, Hh, Ss, Ss, Ww, Ss, Ss, Ss, Ww, Ss, Ss, Ss, Ss, Ww, Wwf, Ss, Gg, Ss, Ww, Ss, Ss, Hh, Ww, Ss, Hh, Mm, Ms
Gd, Gd, Gd, Gd, Gd, Gd, Gd, Gd, Rd, Gd, Mm, Gd, Gd, Gd, Gd, Gd, Gd, Gd, Gd, Gd, Gd, Gd, Gd, Gd, Gd, Gd, Gd, Gd, Gd, Gd, Mm, Gd, Mm, Gd, Ss, Gd, Hh, Mm^Xm, Mm^Xm, Hh, Hh, Ww, Wo, Ss, Hh, Ss, Mm, Hh, Ss, Ss, Hh, Ss, Ss, Ww, Ww, Mm, Hh, Ss, Ww, Ss, Chs, Chs, Ss, Hh, Ss, Ss, Ss, Ww, Wo, Mm^Xm, Mm^Xm, Mm
Mm, Mm, Gd, Gd, Gd, Mm, Mm, Gd, Rd, Gd, Gd, Gd, Gd, Gd, Gd, Gd, Gd, Gd, Gd, Gd, Gd, Gd, Gd, Gd, Gd, Gd, Gd, Gd, Gd, Gd, Mm, Mm, Mm, Mm, Mm, Mm, Mm^Xm, Mm^Xm, Ms^Xm, Mm^Xm, Mm^Xm, Mm, Wo, Wo, Mm^Xm, Hh, Mm, Hh, Chs, Chs, Hh, Ss, Mm, Mm, Ms, Ms, Ww, Ww, Hh, Chs, 2 Khs, Chs, Md, Hh, Hh, Ss, Hh, Ss, Mm^Xm, Ww, Ww, Ms
Mm, Mm, Mm, Gd, Gd, Gd, Gd, Mm, Gd, Rd, Gd, Gd, Gd, Gd, Gd, Gd, Gd, Gd, Gd, Gd, Gd, Gd, Gd, Gd, Gd, Gd, Gd, Gd, Gd, Gd, Mm, Mm, Mm^Xm, Mm, Mm^Xm, Mm^Xm, Mm^Xm, Ms^Xm, Ms^Xm, Ms^Xm, Mm^Xm, Mm^Xm, Ww, Mm, Mm^Xm, Mm, Gg^Efm, Mm, 3 Khs, Chs, Mm, Mm, Ms, Ms, Ms, Ms, Ms^Xm, Hh, Md, Ss, Mm, Md, Mm^Xm, Gg, Mm^Xm, Mm, Mm^Xm, Mm^Xm, Mm, Hh, Hh, Ww
Mm, Mm, Mm, Gg, Gd, Gd, Gd, Gd, Gd, Rd, Rd, Gd, Gd, Gd, Gd, Gd, Mm, Gd, Gd, Gd, Gd, Gd, Gd, Gd, Mm, Gd, Gd, Gd, Ww, Mm, Mm^Xm, Mm^Xm, Mm, Mm^Xm, Mm, Ms, Md, Mm^Xm, Mm^Xm, Mm^Xm, Mm^Xm, Ww, Mm^Xm, Mm^Xm, Mm^Xm, Gg, Mm^Xm, Mm, Mm, Mm, Hh, Ms, Ms, Ms, Ms^Xm, Ms^Xm, Ms, Md, Md, Gg^Efm, Md, Md, Mm^Xm, Mm^Xm, Ms^Xm, Mm^Xm, Mm^Xm, Hh, Mm^Xm, Mm, Ms^Xm, Ms
Gg, Mm, Gg, Gg, Gg, Gd, Gd, Gd, Gd, Rd, Rd, Gd, Gd, Gd, Mm, Hh, Mm, Mm^Xm, Gd, Gd, Gd, Gd, Mm^Xm, Mm, Mm, Mm, Mm^Xm, Ms, Mm^Xm, Mm^Xm, Mm^Xm, Mm^Xm, Mm, Mm, Mm, Hh, Hh^Fp, Mm, Mm, Wo, Ms, Ms^Xm, Ms^Xm, Ms^Xm, Ms^Xm, Ms^Xm, Ms^Xm, Mm^Xm, Mm^Xm, Hh, Mm^Xm, Hh, Mm^Xm, Mm^Xm, Mm^Xm, Mm^Xm, Ms^Xm, Ms^Xm, Mm^Xm, Hh, Mm^Xm, Mm^Xm, Md, Mm^Xm, Mm^Xm, Ms^Xm, Ms^Xm, Hh, Ms^Xm, Ms^Xm, Ms^Xm, Ms^Xm
Wo, Mm, Mm, Gg, Mm, Gg, Mm, Gd, Mm, Gg, Rd, Gd, Mm, Gd, Mm, Mm, Mm, Mm, Gg^Efm, Gd, Gd, Gd, Hh, Mm, Mm^Xm, Mm, Mm^Xm, Mm^Xm, Mm^Xm, Mm^Xm, Mm^Xm, Mm, Mm, Mm, Hh^Fp, Hh, Hh^Fp, Mm, Ms^Xm, Mm, Mm^Xm, Mm^Xm, Md, Ms^Xm, Md, Ms, Wo, Ms^Xm, Ms^Xm, Ms^Xm, Ms^Xm, Ms^Xm, Ms^Xm, Ms^Xm, Ms^Xm, Ms^Xm, Mm^Xm, Ms^Xm, Mm^Xm, Mm^Xm, Md, Rb, Mm, Md, Mm^Xm, Mm^Xm, Md, Mm^Xm, Mm^Xm, Mm, Mm, Hh
Wo, Wo, Wo, Mm, Mm, Mm, Mm, Mm, Mm, Mm, Rd, Mm, Gd, Mm, Mm, Mm, Mm, Gg, Mm, Mm, Mm, Mm^Xm, Mm^Xm, Mm^Xm, Rb, Mm^Xm, Hh, Mm^Xm, Mm^Xm, Mm^Xm, Mm, Mm, Mm, Mm, Gs^Fds, Mm, Gg^Efm, Mm, Mm^Xm, Mm, Md, Ms, Ms, Ms, Md, Ms, Wo, Ms, Ms, Ms^Xm, Ms, Ms^Xm, Ms^Xm, Mm^Xm, Ms, Mm^Xm, Md, Mm^Xm, Md, Md, Md, Rb, Rb, Md, Mm^Xm, Md, Md, Hh, Hh, Hh, Gg, Hh
Wo, Wo, Wo, Mm, Mm, Mm, Mm^Xm, Mm^Xm, Mm, Mm, Mm, Rd, Rd, Gg, Hh, Mm, Mm^Xm, Mm^Xm, Mm, Mm, Mm^Xm, Mm^Xm, Mm, Hh, Hh, Rb, Rb, Mm, Hh, Mm^Xm, Mm, Mm, Mm, Hh, Gs^Fds, Gs^Fds, Gs^Fms, Gs^Fms, Gs^Fms, Gs^Fms, Mm, Hh, Hh, Hh, Gs^Fds, Md, Gs^Fds, Wo, Mm, Ms, Hh, Mm, Hh^Fp, Ms, Mm, Md, Hh^Fms, Mm^Xm, Hh, Hh, Mm, Md, Rb, Mm, Mm^Xm, Hh, Mm, Mm, Mm, Gg, Gg^Efm, Gg
