border_size=1
usage=map

Hhd         , Gd          , Hhd         , Hhd         , Hhd         , Rd          , Rd          , Hhd         , Hhd         , Hhd         , Md          , Hhd         , Hhd         , Hhd         , Gd          , Hhd         , Md          , Hhd         , Hhd         , Hhd         , Md          , Gd          , Rd          , Gd          , Hhd         , Hhd         , Hhd         , Hhd         , Hh          , Hhd         , Hhd         , Hh          , Hhd         , Hh          
Hhd         , Gd          , Hhd         , Hhd         , Hhd         , Hhd         , Gd^Vo       , 3 Rd        , Rd          , Md          , Hhd         , Hhd         , Hhd         , Hhd         , Hhd         , Hhd         , Hhd^Dr      , Hhd         , Md          , Hhd         , Hhd         , Hhd         , Rd          , Gd^Es       , Hhd         , Hhd         , Hhd         , Gd          , Gd          , Hh          , Hh          , Hh          , Hh          , Hh          
Md          , Hhd         , Md          , Hhd         , Md          , Md          , Md          , Md          , Md          , Rd          , Hhd         , Md          , Md          , Md          , Md          , Md          , Md          , Md          , Md          , Md          , Md          , Hhd         , Rd          , Hhd         , Hhd         , Hhd         , Hhd         , Md          , Hhd         , Md          , Hh          , Md          , Hh          , Hh          
Md          , Hhd         , Hhd         , Md          , Hhd         , Md          , Hhd         , Md          , Hhd         , Rd          , Rd          , Md          , Md          , Md          , Hhd         , Md          , Hhd         , Hhd         , Hhd         , Hhd         , Md          , Hhd^Vhhr    , Rd          , Hhd         , Gd          , Md          , Md          , Hhd         , Md          , Hh          , Hhd         , Hhd         , Md          , Md          
Md          , Md          , Md          , Hhd         , Md          , Hhd         , Md          , Md          , Md          , Md          , Md          , Rd          , Md          , Md          , Hhd         , Hhd         , Ke          , Hhd         , Hhd         , Hhd         , Md          , Md          , Rd          , Gd          , Md          , Md          , Hhd         , Hh          , Hhd         , Md          , Hh          , Hh          , Md          , Md          
Md          , Md          , Md          , Md          , Md          , Hhd         , Md          , Md          , Md          , Md          , Md          , Rd          , Md          , Md          , Gd          , Ce          , Gd          , Ce          , Gd          , Gd          , Rd          , Rd          , Gd          , Hhd         , Md          , Hhd         , Hhd         , Hhd         , Hh          , Hhd         , Hh          , Hh          , Hh          , Md          
Md          , Md          , Md          , Md          , Md          , Md          , Md          , Md          , Hhd         , Md          , Md          , Rd          , Rd          , Gd          , Rd          , Rd          , Rd          , Rd          , Rd          , Rd          , Gd          , Hhd         , Hhd         , Gd          , Hhd         , Md          , Hh          , Hh          , Hh          , Hh          , Mm          , Mm          , Mm          , Md          
Md          , Md          , Hhd         , Md          , Md          , Md          , Md          , Hhd         , Md          , Md          , Md          , Md          , Md          , Rd          , Gd          , Gd          , Gd          , Gd          , Gd          , Rd          , Gd          , Gd          , Hhd         , Hhd         , Hhd         , Md          , Hh          , Md          , Mm          , Mm          , Hh^Fp       , Mm          , Ww          , Ww          
Hhd         , Md          , Md          , Gd          , Hhd         , Md          , Md          , Hhd         , Hhd         , Md          , Md          , Md          , Rd          , Rd          , Gd          , Gd          , Gd          , Gd          , Gd          , Rd          , Gd          , Hhd         , Hhd         , Gd          , Md          , Md          , Hh          , Hh          , Mm          , Mm          , Mm          , Ww          , Mm          , Gg^Efm      
Md          , Mv          , Md          , Md          , Md          , Md          , Md          , Md          , Hhd         , Hhd         , 1 Ke        , Ce          , Gd          , Rd          , Gd          , Gd          , Gd          , Gd          , Gd          , Rd          , Gd          , Hhd         , Md          , Md          , Hh          , Gg          , Gg          , Hh          , Wo          , Mm          , Gg^Efm      , Mm          , Ms          , Ms          
Md          , Md          , Md          , Md          , Md          , Md          , Md          , Md          , Hhd         , Gd          , Hhd         , Ce          , Ce          , Rd          , Rd          , Gd^Es       , Gd          , Gd          , Gd          , Rd          , Gd          , Gd^Es       , Gd^Vhr      , Md          , Md          , Hh          , Mm          , Hh          , Hh          , Mm          , Hh          , Gg          , Ms          , Ms          
Hhd         , Md          , Md          , Md          , Md          , Md          , Md          , Gd^Vo       , Hhd         , Hhd         , Gd          , Hhd         , Hhd         , Gd          , Rd          , Rd          , Rd          , Rd          , Rd          , Rd          , Gd          , Gd          , Gd          , Hhd         , Gd          , Mm          , Hh          , Mm          , Ms          , Hh^Fp       , Gg^Efm      , Ms          , Mm          , Mm          
Hhd         , Md          , Hhd         , Md          , Md          , Hhd         , Hhd         , Md          , Hhd         , Gd          , Gd          , Hhd         , Rd          , Rd          , Gd          , Rd          , Gd          , Hhd         , Hhd         , Rd          , Rd          , Gd          , Gd          , Gs          , Gs          , Hh          , Hh          , Ms          , Ww          , Ms          , Ms          , Ms          , Ms          , Mm          
Hhd         , Md          , Hhd         , Md          , Md          , Hhd         , Md          , Md          , Md          , Hhd         , Rd          , Hhd         , Rd          , Gd          , Hhd         , Gd          , Gd          , Md          , Hhd         , Hhd         , Rd          , Gd          , Gs          , Gd          , Hh          , Gd          , Hh          , Ms          , Ww          , Ha          , Ms          , Ms          , Mm          , Mm          
Hhd         , Md          , Hhd         , Hhd         , Md          , Hhd         , Md          , Hhd         , Rd          , Rd          , Md          , Rd          , Hhd         , Hhd         , Hhd         , Hhd         , Md          , Md          , Hhd         , Hhd         , Rd          , Gd          , Gs          , Gs          , Gd          , Gs          , Hh          , Hh          , Ww          , Wo          , Ms          , Ms          , Ms          , Mm          
Hhd         , Md          , Gd^Fdw      , Md          , Hhd         , Md          , Md          , Rd          , Hhd         , Md          , Md          , Md          , Hhd         , Hhd         , Gd          , Md          , Hhd         , Hhd         , Gd          , Gd          , Rd          , Gd          , Gd          , Gd          , Gs          , Gs          , Gg          , Gg          , Ww          , Hh          , Hh          , Hh          , Hh^Fp       , Ms          
Hhd         , Hhd         , Md          , Md          , Hhd         , Hhd         , Rd          , Rd          , Hhd         , Hhd         , Md          , Md          , Md          , Md          , Hhd         , Md          , Gd^Fdw      , Gd          , Gd          , Gd          , Rd          , Rd          , Rd          , Gd          , Gd          , Hh          , Gg          , Gg          , Gg          , Ww          , Ww          , Hh          , Ms          , Ms          
Hhd         , Hhd         , Md          , Md          , Hhd         , Rd          , Hhd         , Gd^Fdw      , Gd^Es       , Gd          , Md          , Md          , Md          , Md          , Md          , Md          , Md          , Hhd         , Gd          , Gd          , Rd          , Gd          , Gd          , Rd          , Rd          , Gd          , Gs          , Gg          , Gs          , Gs          , Hh          , Ww          , Hh          , Gs          
Hhd         , Gd^Fdw      , Hhd         , Md          , Md          , Rd          , Md          , Gd^Fdw      , Md          , Md          , Md          , Md          , Md          , Md          , Md          , Md          , Hhd         , Gd^Fdw      , Gd          , Gd          , Rd          , Gd          , Gd          , Gd          , Hhd         , Rd          , Mm          , Gs          , Gs          , Gg          , Gg          , Ww          , Ww          , Gs          
Hhd         , Gd^Vo       , Md          , Hhd         , Rd          , Rd          , Md          , Md          , Md          , Md          , Md          , Md          , Md          , Md          , Md          , Gd          , Hhd         , Gd          , Gd          , Rd          , Gd          , Gd          , Hhd         , Gd          , Hhd         , Rd          , Mm          , Hh          , Gs          , Gs          , Gg          , Gg          , Gg          , Ww          
Hhd         , Hhd         , Rd          , Rd          , Md          , Hhd         , Md          , Md          , Md          , Hhd         , Md          , Md          , Md          , Md          , Hhd         , Hhd         , Gd^Fdw      , Gd          , Rd          , Rd          , Gd^Fdw      , Hhd         , Md          , Hhd         , Hhd         , Rd          , Rd          , Md          , Md          , Hh          , Hh          , Gg          , Gg          , Gg          
Rd          , Rd          , Hhd         , Md          , Gd^Fdw      , Md          , Md          , Md          , Md          , Md          , Hhd         , Gd          , Hhd         , Md          , Gd          , Hhd         , Hhd         , Gd^Dr       , Rd          , Hhd         , Md          , Md          , Md          , Md          , Md          , Md          , Md          , Rd          , Md          , Md          , Gs^Fms      , Gg          , Gs          , Gs          
Rd          , Mm          , Mm          , Hhd         , Mm          , Hhd         , Mm          , Hhd         , Hhd         , Hhd         , Hhd         , Hhd         , Mm          , Hhd         , Hhd         , Hhd         , Rd          , Rd          , Hhd         , Hhd         , Hhd         , Md          , Md          , Md          , Hhd         , Hhd         , Hhd         , Rd          , Hhd         , Mm          , Mm          , Gg          , Gs          , Gs          
Rd          , Md          , Md          , Md          , Md^Xm       , Mm          , Md^Xm       , Hhd         , Gd^Vo       , Gd^Fdw      , Hhd         , Gd^Fdw      , Gd^Fdw      , Hhd         , Rd          , Rd          , Rd          , Rd          , Gd^Vhr      , Gd          , Gd^Fdw      , Gd^Fdw      , Md          , Gd^Fdw      , Gd          , Gd          , Gd^Fdw      , Rd          , Hhd         , Hhd         , Md          , Mm          , Mm          , Gg          
Md          , Rd          , Rd          , Md          , Hhd         , Md^Xm       , Md          , Gd          , Gd          , Gd          , Gd          , Gd          , Rd          , Rd          , Ce          , Rd          , Ce          , Hhd         , Gd          , Gd          , Gd          , Gd          , Gd^Fdw      , Hhd         , Gd          , Gd^Fdw      , Gd^Fdw      , Rd          , Hhd         , Hhd         , Md          , Mm          , Mm          , Mm          
Gd^Fdw      , Hhd         , Rd          , Gd^Fdw      , Gd^Fdw      , Gd^Fdw      , Gd^Dr       , Gd          , Gd          , Gd          , Md          , Rd          , Rd          , Rd          , Ke          , Ke          , Ce          , Gd          , Gd          , Gd          , Gd          , Gd          , Gd          , Gd          , Hhd         , Gd          , Rd          , Rd          , Gd^Fetd     , Hhd         , Md          , Mm          , Mm          , Mm          
Gd          , Gd          , Rd          , Rd          , Gd^Vo       , Gd          , Gd          , Gd          , Gd^Vhr      , Gd^Fdw      , Rd          , Rd          , Gd          , Ce          , Rd          , Ce          , Rd          , Gd          , Gd^Fdw      , Gd          , Md          , Gd          , Gd          , Gd          , Gd^Vhr      , Gd^Fdw      , Rd          , Rd          , Rd          , Rd          , Rd          , Mm          , Mm          , Mm          
