border_size=1
usage=map

Mm          , Mm          , Mm          , Gg          , Mm          , Mm          , Hh          , Gg          , Mm          , Hh          , Gg          , Hh          , Gg          , Gg          , Gg          , Rb          , Wo^Bw\r     , Wo          , Gg          , Gg          , Gg          , Rb          , Rb^Eff      , Rb^Gvs      , Rb^Gvs      , Rb^Gvs      , Rb^Gvs      , Rb^Gvs      
Mm          , Hh          , Hh          , Mm          , Hh          , Hh          , Hh          , Gg^Efm      , Hh          , Hh          , Mm          , Hh          , Wo          , Gg^Efm      , Ss          , Gg          , Wo          , Rb          , Rb          , Gg          , Rb          , Gg          , Gg          , Rb^Eff      , Rb^Eff      , Rb^Gvs      , Rb^Gvs      , Rb^Gvs      
Mm          , Mm          , Wwf         , Hh          , Hh          , Mm          , Gg^Es       , Hh          , Wo          , Wo          , Wo          , Wo          , Wo          , Wo          , Wo          , Wo          , Wo          , Gg          , Gg          , Rb          , Gg          , Rb          , Rb          , Gg          , Gg          , Rb^Eff      , Rb^Eff      , Rb^Gvs      
Hh          , Mm          , Ww          , Ss          , Hh          , Gg          , Mm          , Mm          , Wo          , Wo          , Ch          , Kh          , Ch          , Wo          , Kh          , Wo          , Wo          , Wo          , Gg          , Gg          , Gg^Efm      , Gg          , Rb^Wm       , Rb          , Rb          , Gg          , Gg          , Rb^Eff      
Wo          , Hh          , Wo          , Wo          , Wo          , Wo          , Wo          , Wo          , Ch          , Ch          , Iwr         , Iwr         , Iwr         , Ch          , Iwr         , Ch          , Ch          , Wo          , Wo          , Wo          , Wo          , Gg          , Gg          , Gg          , Gg          , Rb          , Rb          , Gg          
Wo          , Wo          , Wo          , Wo          , Wo          , Wo          , Ch          , Ch          , Ch          , Iwr         , Iwr         , Iwr         , Iwr         , Ch          , Iwr         , Iwr         , Iwr         , Ch          , Ch          , Wo          , Wo          , Gg          , Gg          , Gg          , Gg          , Gg          , Gs          , Rb          
Wo          , Wo          , Ch          , Kh          , Ch          , Ch          , Iwr         , Iwr         , Iwr         , Iwr         , Iwr         , Iwr         , Iwr         , Ch          , Iwr         , Iwr         , Iwr         , Iwr         , Iwr         , Kh          , Wo          , Hh          , Gg          , Gg          , Gs          , Gg          , Gg          , Gg          
Wo          , Kh          , Iwr         , Iwr         , Iwr         , Iwr         , Iwr         , Iwr         , Ch          , Iwr         , Iwr         , Iwr         , Iwr         , Iwr         , Iwr         , Iwr         , Iwr         , Iwr         , Ch          , Ch          , Wo          , Wo          , Gg          , Gg          , Gg          , Gg          , Rrc         , Rrc         
Ch          , Ch          , Iwr         , Iwr         , Iwr         , Iwr         , Iwr         , Iwr         , Cv          , Iwr         , Iwr         , Iwr         , Iwr         , Iwr         , Iwr         , Iwr         , Ch          , Ch          , Iwr         , Ch          , Kh          , Wo          , Gg          , Gg          , Rrc         , Rrc         , Gs          , Gg          
Iwr         , Iwr         , Ch          , Iwr         , Iwr         , Iwr         , Cv          , Cv          , Gg          , Cv          , Rrc         , Iwr         , Iwr         , Iwr         , Iwr         , Ch          , Iwr         , Iwr         , Iwr         , Ch          , Wo          , Wo          , Rrc         , Rrc         , Gg          , Gg          , Gg          , Gg          
Iwr         , Iwr         , Iwr         , Ch          , Cv          , Cv          , Gg^Efm      , Gs^Fds      , Rrc         , Rrc         , Rb          , Cv          , Cv          , Ch          , Iwr         , Iwr         , Iwr         , Iwr         , Iwr         , Ch          , Wo^Bsb/     , Wo^Bsb/     , Gg          , Rb          , Rb          , Gg          , Gg          , Gs          
Ch          , Iwr         , Cv          , Cv          , Gg          , Gg^Efm      , Rrc         , Rrc         , Ww          , Gg          , Rb          , Gs^Fds      , Cv          , Iwr         , Iwr         , Iwr         , Iwr         , Iwr         , Iwr         , Rrc         , Wo          , Wo          , Gg          , Gg          , Rb          , Gg          , Gs          , Gg          
Iwr         , Cv          , Gg          , Gs^Fds      , Rrc         , Rrc         , Ww^Ewl      , Ww          , Ww^Ewf      , Gg^Efm      , Rb          , Gg          , Cv          , Iwr         , Iwr         , Iwr         , Iwr         , Iwr         , Iwr         , Ch          , Kh          , Wo          , Wo          , Gg          , Gg          , Rb          , Gg          , Gs          
Iwr         , Cv          , Rrc         , Rrc         , Rb          , Gg          , Gg^Fet      , Ww          , Gs^Fds      , Gs^Fds      , Gs^Fds      , Rb          , Cv          , Iwr         , Iwr         , Iwr         , Ch          , Iwr         , Iwr         , Ch          , Wo          , Wo          , Ww^Ewl      , Gg          , Gg          , Rb          , Gg          , Gg          
Iwr         , Rrc         , Gg          , Rb          , Gg          , Rb          , Gg^Efm      , Gs^Fds      , Gg          , Gg          , Rb          , Rb          , Cv          , Iwr         , Iwr         , Ch          , Iwr         , Ch          , Ch          , Ch          , Wo          , Wo          , Gg          , Ss          , Gg          , Rb          , Gs          , Gg          
Ch          , Cv          , Cv          , Rb          , Rb          , Rb          , Gg          , Gs^Fds      , Rb          , Rb          , Gs^Fds      , Gg          , Cv          , Ch          , Iwr         , Iwr         , Iwr         , Iwr         , Ch          , Kh          , Wo          , Wo          , Gg          , Gs          , Gg          , Rb          , Re          , Gg          
Iwr         , Iwr         , Iwr         , Cv          , Cv          , Gs^Fds      , Cv          , Rb          , Cv          , Gg          , Cv          , Cv          , Iwr         , Iwr         , Iwr         , Iwr         , Iwr         , Iwr         , Ch          , Wo          , Wo          , Gg          , Gg          , Gg          , Gs          , Gs^Vh       , Rb          , Gs          
Iwr         , Iwr         , Iwr         , Iwr         , Iwr         , Cv          , Iwr         , Iwr         , Iwr         , Cv          , Iwr         , Iwr         , Iwr         , Iwr         , Iwr         , Iwr         , Iwr         , Iwr         , Ch          , Wo          , Wo          , Gg          , Gg          , Gs          , Gg          , Gg          , Rb          , Gg          
