border_size=1
usage=map

Uu, Uu, Uu, Uu, Uu, Uu, Uu, Uu, Uu, Uu, Uu, Uu, Uu, Uu, Uu, Uu, Uu, Uu, Uu, Uu, Uu, Uu, Uu, Uu, Uu, Uu, Uu, Uu, Uu, Uu, Uu, Uu, Uu, Uu, Uu, Uu, Uu, Uu, Uu, Uu, Uu, Uu, Uu, Uu, Uu, Uu, Uu, Uu, Uu, Uu, Uu, Uu, Uu, Uu, Uu, Uu, Uu, Uu, Uu, Uu, Uu, Uu, Uu, Uu, Uu, Uu, Uu, Uu, Uu, Uu, Uu, Uu, Uu, Uu, Uu, Uu, Uu, Uu, Uu, Uu, Uu, Uu, Uu, Uu, Uu, Uu, Uu, Uu, Uu, Uu, Uu, Uu, Uu, Uu, Uu, Uu, Uu, Uu, Uu, Uu, Uu, Uu, Uu, Uu, Uu, Uu, Uu, Uu
Uu, Uu, Uu, Uu, Uu, Uu, Uu, Uu, Uu, Uu, Uu, Uu, Uu, Uu, Uu, Uu, Uu, Uu, Uu, Uu, Uu, Uu, Uu, Uu, Uu, Uu, Uu, Uu, Uu, Uu, Uu, Uu, Uu, Uu, Uu, Uu, Uu, Uu, Uu, Uu, Uu, Uu, Uu, Uu, Uu, Uu, Uu, Uu, Uu, Uu, Uu, Uu, Uu, Uu, Uu, Uu, Uu, Uu, Uu, Uu, Uu, Uu, Uu, Uu, Uu, Uu, Uu, Uu, Uu, Uu, Uu, Uu, Uu, Uu, Uu, Uu, Uu, Uu, Uu, Uu, Uu, Uu, Uu, Uu, Uu, Uu, Uu, Uu, Uu, Uu, Uu, Uu, Uu, Uu, Uu, Uu, Uu, Uu, Uu, Uu, Uu, Uu, Uu, Uu, Uu, Uu, Uu, Uu
Uu, Uu, Uu, Uu, Uu, Uu, Uu, Uu, Uu, Uu, Uu, Uu, Uu, Uu, Uu, Uu, Uu, Uu, Uu, Uu, Uu, Uu, Uu, Uu, Uu, Uu, Uu, Uu, Uu, Uu, Uu, Uu, Uu, Uu, Uu, Uu, Uu, Uu, Uu, Uu, Uu, Uu, Uu, Uu, Uu, Uu, Uu, Uu, Uu, Uu, Uu, Uu, Uu, Uu, Uu, Uu, Uu, Uu, Uu, Uu, Uu, Uu, Uu, Uu, Uu, Uu, Uu, Uu, Uu, Uu, Hhd, Uu, Hhd, Uu, Hhd, Uu, Hhd, Uu, Hhd, Uu, Gg, Uu, Gs, Uu, Gg, Uu, Rrc, Uu, Gg, Uu, Gg, Uu, Wwg, Uu, Ww, Uu, Gg, Uu, Gg, Uu, Gs, Uu, Gs, Uu, Gg, Uu, Uu, Uu
Uu, Uu, Uu, Uu, Uu, Uu, Uu, Uu, Uu, Uu, Uu, Uu, Uu, Uu, Uu, Uu, Uu, Uu, Uu, Uu, Uu, Uu, Uu, Uu, Uu, Uu, Uu, Uu, Uu, Uu, Uu, Uu, Uu, Uu, Uu, Uu, Uu, Uu, Uu, Uu, Uu, Uu, Uu, Uu, Uu, Uu, Uu, Uu, Uu, Uu, Uu, Uu, Uu, Uu, Uu, Uu, Uu, Uu, Uu, Uu, Uu, Uu, Uu, Uu, Uu, Uu, Uu, Uu, Uu, Hhd, Gd^Es, Hhd, Gd^Es, Hhd, Gd^Es, Hhd, Gd, Hhd, Gs^Es, Gs, Gg^Es, Gs, Gg^Efm, Gg^Efm, Gs^Efm, Gg^Efm, Rrc, Rrc, Gg^Em, Gg, Gg^Efm, Gg^Efm, Gg^Efm, Wwg, Ww, Gg^Efm, Gg^Em, Gg^Efm, Gg^Efm, Gg, Gs, Gs, Gg, Gs, Rp, Uu, Uu, Uu
Uu, Uu, Uu, Uu, Uu, Uu, Uu, Uu, Uu, Uu, Uu, Uu, Uu, Uu, Uu, Uu, Uu, Uu, Uu, Uu, Uu, Uu, Uu, Uu, Uu, Uu, Uu, Uu, Uu, Uu, Uu, Uu, Uu, Uu, Uu, Uu, Uu, Uu, Uu, Uu, Uu, Uu, Uu, Uu, Uu, Uu, Uu, Uu, Uu, Uu, Uu, Uu, Uu, Uu, Uu, Uu, Uu, Uu, Uu, Uu, Uu, Uu, Uu, Uu, Uu, Uu, Uu, Uu, Uu, Gs^Dr, Gd^Edp, Gd^Es, Gd^Es, Gd^Es, Gs^Es, Gd^Es, Gs^Es, Gd^Es, Gs, Gs^Es, Gg, Gg^Efm, Gg^Efm, Gs, Gg, Gg, Rrc, Rrc, Gg, Gg, Gg^Em, Gg, Gg^Efm, Wwg, Wwg, Gg, Gg, Gg^Efm, Gg, Gg, Gg, Gg, Rr, Rp, Rr, Uu, Uu, Uu
Uu, Uu, Uu, Uu, Uu, Uu, Uu, Uu, Uu, Uu, Uu, Uu, Uu, Uu, Uu, Uu, Uu, Uu, Uu, Uu, Uu, Uu, Uu, Uu, Uu, Uu, Uu, Uu, Uu, Uu, Uu, Uu, Uu, Uu, Uu, Uu, Uu, Uu, Uu, Uu, Uu, Uu, Uu, Uu, Uu, Uu, Uu, Uu, Uu, Uu, Uu, Uu, Uu, Uu, Uu, Uu, Uu, Uu, Uu, Uu, Uu, Uu, Uu, Uu, Uu, Uu, Uu, Uu, Uu, Gs, Hhd, Gd^Es, Gs^Es, Gs, Gs^Es, Gs^Edpp, Gs, Gs, Gs, Gs, Gs, Gs, Gs, Gg, Gs, Gg, Rrc, Rrc, Gg, Gg, Gg, Gg, Gg, Gg, Ww, Wwg, Wwg, Gg^Efm, Gg^Efm, Gg, Rr, Rr, Rr, Rr, Gg, Uu, Uu, Uu
Uu, Uu, Uu, Uu, Uu, Uu, Uu, Uu, Uu, Uu, Uu, Uu, Uu, Uu, Uu, Uu, Uu, Uu, Uu, Uu, Uu, Uu, Uu, Uu, Uu, Uu, Uu, Uu, Uu, Uu, Uu, Uu, Uu, Uu, Uu, Uu, Uu, Uu, Uu, Uu, Uu, Uu, Uu, Uu, Uu, Uu, Uu, Uu, Uu, Uu, Uu, Uu, Uu, Uu, Uu, Uu, Uu, Uu, Uu, Uu, Uu, Uu, Uu, Uu, Uu, Uu, Uu, Uu, Uu, Hhd, Gd, Gs^Es, Hhd, Gs, Gs^Es, Gs^Es, Gs, Gs, Ke, Ce, Ke, Ke, Ke, Ke, Ke, Ce, Rrc, Rrc, Ce, Ce, Ce, Ce, Ce, Ce, Ce, Ww, Ww, Gg, Rr, Rr, Rr, Rr, Gg, Gg, Ss, Uu, Uu, Uu
Uu, Uu, Uu, Uu, Uu, Uu, Uu, Uu, Uu, Uu, Uu, Uu, Uu, Uu, Uu, Uu, Uu, Uu, Uu, Uu, Uu, Uu, Uu, Uu, Uu, Uu, Uu, Uu, Uu, Uu, Uu, Uu, Uu, Uu, Uu, Uu, Uu, Uu, Uu, Uu, Uu, Uu, Uu, Uu, Uu, Uu, Uu, Uu, Uu, Uu, Uu, Uu, Uu, Uu, Uu, Uu, Uu, Uu, Uu, Uu, Uu, Uu, Uu, Uu, Uu, Uu, Uu, Uu, Uu, Gs^Edpp, Gd, Gs^Es, Gs^Es, Gs^Es, Gs, Gs, Ke, Ke, Ke, Ke, Ke, Ke, Ke, Ke, Rrc, Rrc, Rrc, Rrc, Rrc, Rrc, Rrc, Rrc, Rr, Gg, Gg, Ce, Rr, Wwf^Bw/, Wwf^Bw/, Rr, Gg, Gg^Efm, Gg^Em, Ss, Gg, Uu, Uu, Uu
Uu, Uu, Uu, Uu, Md, Uu, Gg^Es, Uu, Hh, Uu, Md, Uu, Md, Uu, Hh, Uu, Md, Uu, Hh^Fp, Uu, Gg^Efm, Uu, Ww, Uu, Ww, Uu, Gg, Uu, Ss, Uu, Sm, Uu, Ds, Uu, Gg, Uu, Hh^Fds, Uu, Mm, Uu, Ms, Uu, Mm, Uu, Ms^Xm, Uu, Hh^Fp, Uu, Mm, Uu, Mm, Uu, Hh^Fp, Uu, Mm, Uu, Mm^Xm, Uu, Hh^Fp, Uu, Hh^Fp, Uu, Mm, Uu, Hh, Uu, Hhd^Fdw, Uu, Hhd, Gs, Gd^Es, Gs, Gd^Es, Gs^Es, Ce, Ke, Ke, Ke, Ke, Ke, Ke, Ke, Rrc, Rrc, Rrc, Rrc, Rrc, Rrc, Rrc, Rrc, Rrc, Rrc, Rr, Rr, Rrc, Rr, Rr, Rr, Wwf, Wwf, Ww, Gg, Gg^Em, Ss, Ss, Uu, Uu, Uu
Uu, Uu, Uu, Md, Md, Gg^Es, Gg, Gg^Efm, Md, Md, Ms^Xm, Ms^Xm, Md, Hh, Md, Hh, Md, Hh^Fp, Hh, Gg, Gg^Efm, Ss, Ss, Gg^Efm, Ww, Ww, Gg, Ds, Ss, Ds, Sm, Ss, Ss, Ww, Gg^Efm, Ss, Hh^Fp, Mm, Mm, Ms^Xm, Ms^Xm, Mm, Mm, Ms, Ms, Hh^Fp, Mm, Mm, Mm, Mm, Mm, Mm, Mm, Mm, Mm, Hh, Mm^Xm, Hh, Hh, Hh^Fp, Hh, Hh, Gs, Mm, Hh, Hhd, Hhd^Fdw, Hhd, Hhd, Hhd, Gs^Es, Gs^Edpp, Gs, Gs, Ke, Ke, Ce, Ce, Ce, Ke, Rrc, Rrc, Rrc, Rrc, Rrc, Rrc, Rrc, Rrc, Rr, Rrc, Rrc, Rrc, Rrc, Rr, Rrc, Rrc, Rp, Ce, Ce, Wwg, Wwg, Sm, Sm, Ss, Ss, Uu, Uu, Uu
Uu, Uu, Uu, Md, Ms, Ww, Hh, Hh, Md, Md, Ms^Xm, Md, Md, Hh^Fp, Md, Md, Hh, Hh, Gs, Gg, Gg, Gg^Efm, Gg^Efm, Gg^Efm, Ds, Ww, Ww, Ss, Ss, Ss, Ss, Ss, Ww, Wwf, Ss, Ss, Gg^Efm, Hh, Hh, Mm, Mm, Ms^Xm, Ms^Xm, Ms, Ms, Mm, Mm^Xm, Mm, Mm, Mm, Mm, Mm, Ms^Xm, Mm, Mm, Mm, Mm^Xm, Hh^Fp, Hh, Hh, Hh, Gs, Gd, Gs, Gs, Gs^Es, Gs, Hhd, Hhd, Hhd, Gd, Gs, Gs, Gs, Ke, Ke, Ce, Ke, Rrc, Rrc, Rrc, Rrc, Rrc, Rrc, Rrc, Rrc, Rrc, Rrc, Rr, Rr, Rr, Rrc, Rr, Rr, Rrc, Rrc, Rb, Ss, Sm, Ce, Ww, Wwg, Ss, Gg^Efm, Gg, Uu, Uu, Uu
Uu, Uu, Uu, Ms, Md, Hh, Hh, Md, Ms^Xm, Ms^Xm, Ms, Ms, Md, Md, Hh^Fp, Hh^Vhh, Hh, Hh, Gs, Gs, Gg, Gg, Ds, Sm, Ss, Ds, Ww, Ww, Ww, Ds, Ww, Gg, Wwg, Wot, Hh, Gg, Gg, Gg, Gs, Gs^Es, Hh, Mm, Ms^Xm, Ms^Xm, Ms, Mm, Mm^Xm, Hh^Fp, Ms^Xm, Mm^Xm, Mm^Xm, Mm^Xm, Mm, Mm^Xm, Mm, Mm^Xm, Mm, Mm, Mm, Hh, Hh, Hhd, Gd, Gs, Gs, Gd^Es, Gd^Edpp, Gs, Gs, Gs^Es, Gd^Dr, Gs^Es, Gs, Gs, Ce, Ke, Rrc, Rrc, Rrc, Rrc, Rrc, Rrc, Rrc, Rrc, Rrc, Rrc, Rrc, Rrc, Rr, Rrc, Rr, Rr, Rr, Rr, Rp, Rr, Rd, Rd, Sm, Ce, Ww, Wwg, Wwg, Ss, Gg, Uu, Uu, Uu
Uu, Uu, Uu, Ms, Md, Md, Mm, Mm, Mm, Ms^Xm, Ms^Xm, Ms, Ww, Hh, Hh, Hh, Gg^Efm, Gg, Gg^Efm, Gg, Gg^Efm, Gg, Ss, Ss, Ww, Ww, Ds, Ds, Ss, Ww, Ww, Gg^Efm, Wot, Hh^Vhh, Mm, Hh, Gg^Efm, Gg^Efm, Gs^Es, Hh, Hh, Mm, Ms^Xm, Ms, Ms, Mm, Mm^Xm, Ww, Ms^Xm, Mm, Mm, Mm, Mm, Mm, Ms^Xm, Mm^Xm, Mm, Mm, Hh^Fp, Mm, Gs, Gs, Gs, Gd^Edpp, Gs, Gs, Gd, Gs, Gs^Edp, Gd^Es, Gd^Es, Gs^Es, Gs, Gs, Ce, Rrc, Rrc, Rrc, Rrc, Rrc, Rrc, Rrc, Rrc, Rrc, Rrc, Rrc, Rrc, Rr, Rr, Rr, Rr, Rp, Rp, Rr, Rp, Rd, Rp, Rp, Sm, Ce, Ce, Ww, Wwg, Ss, Ss, Uu, Uu, Uu
Uu, Uu, Uu, Ms^Xm, Ms^Xm, Md, Mm, Mm, Mm, Mm, Ms^Xm, Ms^Xm, Mm, Ww, Ww, Ww, Ww, Gg^Efm, Ww, Ss, Ww, Ww, Ww, Ww, Ss, Ds, Ss, Ss, Sm, Ds, Gg, Wwf, Wot, Ss, Hh^Fds, Hh, Hh, Gg, Gs, Hh, Mm, Mm^Xm, Mm^Xm, Ms, Mm, Mm, Ms^Xm, Ms^Xm, Mm, Mm, Mm, Mm^Xm, Mm^Xm, Mm^Xm, Ms^Xm, Mm, Mm, Hh^Vhh, Hh, Hh, Gd, Gd, Gd, Gd^Es, Gd^Es, Gd, Gd^Edpp, Gs, Gs, Gs, Gs^Es, Gs^Es, Gs, Gs, Ce, Rrc, Rrc, Rrc, Rrc, Rrc, Rrc, Rrc, Gs, Gs, Gg, Rrc, Rrc, Rrc, Rr, Rr, Rr, Rr, Rr, Rp, Rd, Rd, Rp, Rp, Rb, Ss, Ce, Ww, Ww, Ss, Ss, Uu, Uu, Uu
Uu, Uu, Uu, Hh^Fp, Md, Ms^Xm, Hh^Fp, Mm, Hh^Fp, Mm, Mm, Ms^Xm, Ms, Mm, Hh, Gg^Efm, Ds, Ww, Hh, Ww, Ss, Ds, Ss, Sm, Sm, Ss, Ss, Ds, Ss, Ss, Gg, Wot, Wot, Hh, Mm, Mm, Hh, Gg, Hh, Mm, Mm, Mm^Xm, Mm^Xm, Mm, Mm, Mm, Mm^Xm, Mm, Mm, Mm, Hh, Hh, Hh, Mm, Mm, Mm^Xm, Mm, Mm, Hh, Hh, Gs, Gs, Mm, Gs, Gs, Gs, Gd, Gd, Gs, Gs^Es, Gs^Es, Gs, Gs, Gs, Ce, Rrc, Rrc, Rrc, Rrc, Rrc, Rrc, Rrc, Gs, Gs, Wot, Gg^Fet, Rrc, Rrc, Rr, Rr, Rr, Rr, Rr, Rp, Rr, Rr, Rp, Rb, Rb, Gg, Ce, Ww, Ww, Ss, Ss, Uu, Uu, Uu
Uu, Uu, Uu, Hh^Fp, Md, Ms^Xm, Ms^Xm, Hh^Vhh, Hh^Fp, Hh, Mm, Mm, Ms, Mm, Hh, Gg, Ds, Hh, Ss, Ss, Gg^Efm, Ss, Gg, Ds, Ss, Ss, Gg, Ss, Ds, Ss, Ss, Ss, Wot, Ss, Hh^Fds, Mm, Gg, Gg, Hh, Hh, Gg, Mm^Xm, Ms^Xm, Ms^Xm, Mm, Mm, Wo, Ms^Xm, Mm, Hh, Gg, Hh, Hh^Fp, Hh, Mm, Mm^Xm, Wo, Mm, Mm, Hh, Hh, Gs, Gs, Gd, Gd, Gs^Es, Gd, Gs, Gs, Gg, Gs, Gs, Gs, Gs, Ce, Rrc, Rrc, Rrc, Rrc, Rrc, Rrc, Rrc, Gg, Gg, Gg, Gg, Rrc, Rr, Rp, Rr, Rp, Rp, Rr, Rd, Rd, Rr, Rp, Rp, Rp, Sm, Ce, Ww, Wwg, Ss, Ww, Uu, Uu, Uu
Uu, Uu, Uu, Md, Md, Ms^Xm, Md, Hh, Gg^Efm, Hh, Gg^Efm, Mm, Mm, Mm, Hh, Gg, Gg, Ss, Ds, Ds, Re, Ss, Rb, Rb, Ss, Ds, Rb, Ss, Rb, Gg, Gg, Wot, Wot, Hh^Fds, Mm, Mm, Gg, Gg^Efm, Gs, Gg, Hh, Mm, Mm^Xm, Mm^Xm, Ms^Xm, Hh^Fp, Ms^Xm, Ms^Xm, Mm, Gg, Gg, Hh, Hh, Mm, Mm, Mm, Wo, Mm, Mm, Mm, Mm, Hh, Hh, Hh, Hh, Gs, Gs, Gs^Es, Gd^Es, Gd, Gg, Gs, Gg, Gs, Ce, Rrc, Rrc, Rrc, Rrc, Rrc, Rrc, Rrc, Rrc, Gg, Rrc, Rrc, Rrc, Re, Rr, Rr, Rr, Rp, Rp, Rd, Rr, Rr, Rp, Rp, Rp, Sm, Ce, Ww, Ww, Ww, Ss, Uu, Uu, Uu
Uu, Uu, Uu, Ms^Xm, Ms^Xm, Ms^Xm, Gg^Efm, Hh, Gg, Gg^Efm, Mm, Mm, Mm, Hh, Ss, Ss, Ds, Gg, Ss, Rb, Ds, Gg, Ss, Gg, Gg^Efm, Gg, Ds, Gg, Ss, Re, Rb, Wot, Wot, Hh, Hh, Hh, Gs, Gg, Gs^Es, Hh, Hh, Hh^Vhh, Mm, Mm^Xm, Ms^Xm, Mm^Xm, Mm, Mm, Mm, Gg, Gs, Gg, Mm, Mm, Mm, Ms^Xm, Ms, Ha^Fda, Mm, Mm, Mm, Mm, Mm, Hh, Gs, Gs, Gs, Gd, Gs, Gd, Rrc, Rrc, Rrc, Rrc, Rrc, Rrc, Rrc, Rrc, Rrc, Rrc, Rrc, Rr, Rrc, Rrc, Rr, Rr, Rr, Rr, Rr, Rr, Rr, Rp, Rp, Rd, Rd, Rr, Gll, Rp, Gg, Ce, Ww, Ww, Wwg, Ss, Sm, Uu, Uu, Uu
Uu, Uu, Uu, Md, Md, Hh^Fp, Hh, Gs, Gg^Es, Gs, Hh, Mm, Mm, Hh, Gg, Gg, Rb, Rb, Ss, Ss, Ww, Ds, Ww, Ss, Ds, Ds, Ww, Ww, Ww, Gg^Efm, Wot, Wot^Bw\, Wot^Bw\, Hh, Rb, Gs, Gs, Gs, Gs, Gs, Hh, Hh, Mm, Ms, Ms, Mm^Xm, Mm, Hh^Vhh, Hh, Gs, Hh, Hh, Hh, Mm, Mm^Xm, Mm^Xm, Ms^Xm, Ms, Mm, Mm, Mm, Mm, Mm, Hh, Gs, Gs^Es, Gd, Gs, Rrc, Rr, Gd, Gs, Gs, Gg, Ce, Rr, Rr, Rr, Rr, Rrc, Rr, Rr, Re, Rr, Rr, Rr, Rr, Rr, Rp, Rr, Rp, Rd, Rr, Rd, Rrc, Rd, Rd, Rp, Ce, Ce, Ww, Wwg, Ss, Ss, Ss, Uu, Uu, Uu
Uu, Uu, Uu, Wo, Md, Hh, Hh, Gg, Gs, Gs, Hh, Mm, Hh, Hh, Gg, Rb, Gg, Ds, Ss, Ww, Wot, Ww, Wot, Wot, Wot, Ww, Wot, Wot, Wot, Wot, Wot, Wot, Hh, Rb, Gg, Rb, Ss, Gs, Gg, Gs^Es, Gs, Hh, Ww, Ms, Ms, Mm^Xm, Mm, Hh, Chr, Khr, Chr, Hh^Vhh, Mm, Mm, Mm, Mm, Mm, Mm^Xm, Mm^Xm, Mm, Mm, Mm, Mm, Hh, Gs, Gs, Rp, Rrc, Gs, Gs, Gs, Gs^Es, Gd, Gs, Ce, Re, Rr, Rr, Re, Rr, Rp, Rr, Rp, Re, Rr, Re, Rr, Rr, Rr, Rr, Re, Rr, Rr, Rr, Rrc, Rd, Gll, Rb, Ce, Ww, Wwg, Wwf, Sm, Sm, Ss, Uu, Uu, Uu
Uu, Uu, Uu, Md, Md, Hh, Gs, Gs^Es, Gs, Gg, Gg, Mm, Gg, Gg, Rb, Rb, Gg, Ds, Ss, Ww, Wot, Wot, Ss, Wot, Mm, Wot, Mm, Hh, Ss, Wot, Ww, Ww, Ww, Mm, Ww, Gg^Efm, Ss, Rb, Rb, Gg, Ww, Ww, Mm, Mm, Mm^Xm, Mm^Xm, Mm, Mm, Mm, Chr, Rp, Gg^Efm, Mm, Mm, Mm, Mm, Mm, Mm, Mm, Mm^Xm, Mm^Xm, Mm, Hh, Gs, Rr, Rp, Gs, Gs, Gg, Gs^Wm, Gs, Gd, Gs^Wm, Gs, Gg, Ce, Rr, Rp, Re, Rp, Rp, Rp, Rd, Re, Rr, Rr, Rp, Rp, Re, Rp, Re, Rp, Re, Rd, Re, Re, Rb, Ce, Ww, Ww, Sm, Ss, Sm, Wwf, Sm, Uu, Uu, Uu
Uu, Uu, Uu, Md, Md, Md, Gg, Gg, Gg, Gg, Gs, Gg, Gs, Re, Gg, Gg, Gg, Ss, Wot, Wot, Wot, Hh, Ss, Mm, Mm, Mm, Ms^Xm, Md, Md, Ss, Ss, Hh, Mm, Ww, Mm, Ww, Ww, Gs, Ww, Ww, Ww, Mm, Mm, Mm, Mm^Xm, Mm, Mm, Mm, Mm, Mm, Rp, Hh, Hh, Mm, Gs, Mm, Mm, Mm, Mm, Mm^Xm, Mm, Hh, Rr, Rr, Gg, Gd, Gs, Gs, Gs, Gs, Gd, Gd, Gs, Gs, Gs, Ce, Ce, Rr, Re, Rp, Rp, Re, Re, Rr, Rp, Rp, Rp, Rp, Re, Rp, Re, Re, Rp, Rp, Re, Re, Rb, Ce, Ww, Wwg, Sm, Ss, Wwf, Sm, Sm, Uu, Uu, Uu
Uu, Uu, Uu, Hh, Hh, Hh, Gs, Gg, Gg, Gs, Re, Rb, Gg, Gg^Es, Ss, Ss, Gg, Gg^Efm, Wwf, Wot, Wot, Wot, Hh, Mm, Mm, Mm, Hh^Fms, Ms^Xm, Mm, Mm, Mm, Mm, Mm, Mm, Hh, Ww, Mm, Ww, Ss, Sm, Gs, Mm, Mm^Xm, Mm^Xm, Mm, Mm^Xm, Hh, Hh, Re, Gs, Re, Gs^Es, Gs, Gs, Hh, Mm, Mm, Mm, Mm^Xm, Mm^Xm, Rp, Rr, Hh, Gs, Gg, Gg, Gs, Gs^Es, Gs, Gs^Edpp, Gs^Es, Gs, Gs^Wm, Gs, Gs, Gs, Ce, Re, Rp, Rb, Re, Rd, Re, Rp, Rp, Rp, Re, Rp, Re, Re, Re, Re, Re, Re, Re, Re, Re, Ce, Wwg, Sm, Ss, Ss, Ss, Sm^Em, Sm, Uu, Uu, Uu
Uu, Uu, Uu, Gg, Gs, Gs, Gs^Es, Gs, Gg, Rb, Gg, Gg, Gg, Ss, Ds, Gg^Efm, Gg, Ww, Wot, Wot, Wwf, Gg^Efm, Hh, Mm, Mm, Mm, Mm, Mm, Mm, Mm, Mm, Mm, Mm, Mm, Mm, Ms^Xm, Ms^Xm, Ww, Mm, Re, Hh, Mm, Mm^Xm, Hh, Hh, Hh, Re, Gs, Hh, Re, Re, Gs, Mm, Gs, Gs^Es, Hh, Hh^Vhh, Mm, Mm^Xm, Hh, Re, Mm, Mm, Hh, Gs, Gs, Gs^Es, Gs, Gs, Gg, Gd, Gs, Gg^Efm, Gg^Efm, Gg^Eff, Gs^Eff, Ce, Re, Rb, Re, Re, Re, Rb, Re, Rp, Re, Re, Re, Rb, Re, Re, Re, Re, Re, Re, Re, Re, Wwg^Bw\, Wwg^Bw\, Ss, Gg^Efm, Gg, Ss, Ss, Ss, Uu, Uu, Uu
Uu, Uu, Uu, Gg, Gs, Gs, Re, Gs, Gg, Gg, Gs, Gg, Ss, Ss, Ss, Gg, Ww, Ww, Wot, Ss, Ww, Gg, Hh, Ss, Ss, Hh^Fp, Hh, Mm, Mm, Mm, Mm, Mm, Md, Mm, Mm, Mm, Mm, Ms^Xm, Mm, Re, Re, Hh, Hh, Hh^Vhh, Gs, Re, Hh, Gs, Mm, Hh, Gs, Re, Rp, Gs, Re, Gs, Mm, Mm, Hh, Re, Mm, Mm, Hh, Hh, Hh, Gs, Gs, Gs, Gs, Gg^Efm, Gg, Gg, Gg^Eff, Gg^Eff, Rb^Gvs, Rb^Gvs, Rb^Gvs, Ce, Ce, Rb, Re, Re, Re, Re, Re, Rb, Rb, Rb, Rb, Rb, Rb, Re, Sm, Rb, Ce, Ce, Ww, Wwg^Bw\, Rb, Rb, Rb, Ss, Ss, Ss, Gg^Em, Uu, Uu, Uu
Uu, Uu, Uu, Gg, Re, Re, Gg, Gg, Gg^Efm, Gg, Gg, Gg, Gg, Gg, Ds, Gg^Efm, Wot, Wot, Ss, Ww, Ww, Hh, Wwf, Ww, Ww, Gg^Efm, Hh, Hh^Efm, Wwf, Hh^Fp, Hh^Vhh, Md, Ms^Xm, Ms^Xm, Mm, Mm, Mm, Mm, Mm, Gs, Gs, Gs, Gs, Hh, Re, Hh, Mm, Hh, Mm, Mm, Gs, Hh, Mm, Mm, Mm, Rp, Re, Mm, Rp, Rr, Mm^Xm, Mm^Xm, Mm, Hh, Hh, Hh, Hh, Gs, Gg, Gg^Efm, Gg^Eff, Gg^Eff, Rb^Gvs, Rb^Gvs, Rb^Gvs, Rb^Gvs, Rb^Gvs, Rb^Gvs, Rb^Gvs, Ce, Rb, Rb, Rb, Rb, Rb, Rb, Rb, Rb, Rb, Rb, Ce, Gg, Ce, Ce, Ss, Ww, Wwg, Wwg, Ss, Rb, Rb, Rb, Rb, Ss, Gg, Uu, Uu, Uu
Uu, Uu, Uu, Re, Gg, Gs, Gs^Es, Gs, Ds, Ss, Gg, Ss, Gg^Efm, Ds, Ww, Wot, Wot, Ww, Ss, Gg^Efm, Hh, Wwf, Gg^Efm, Hh, Hh, Wwf, Ww, Ww, Mm, Wwf, Mm, Mm, Ms^Xm, Mm, Hh, Mm, Mm, Mm, Mm, Gg^Efm, Gg, Gs, Gs, Re, Gs, Gg^Efm, Gs, Gs, Gs, Mm, Gs, Hh, Hh^Fp, Mm, Mm, Mm, Gs, Re, Hh, Mm, Mm^Xm, Mm, Mm, Hh^Vhh, Hh, Hh, Gs, Gs, Gg^Eff, Gg^Eff, Rb^Gvs, Rb^Gvs, Rb^Gvs, Rb^Gvs, Rb^Gvs, Rb^Gvs, Rb^Gvs, Rb^Gvs, Rb^Gvs, Rb^Gvs, Rb, Ce, Ce, Ce, Ce, Ce, Ce, Ce, Ce, Ce, Rb^Emf, Ce, Sm, Ss, Wwg, Wwg, Gg^Efm, Gg^Efm, Gg^Efm, Ss, Gg, Rb, Rb, Rb, Rb, Uu, Uu, Uu
Uu, Uu, Uu, Gg, Gg, Gg, Gg^Efm, Gg, Ss, Ss, Ss, Ss, Ww, Ww, Wot, Wot, Gg, Ds, Mm, Mm, Mm, Mm, Mm, Hh^Vhh, Mm, Hh^Fp, Mm, Mm, Mm, Mm, Ms^Xm, Ms^Xm, Md, Md, Mm, Hh, Hh, Mm, Mm, Gs, Gs^Es, Gs, Gs, Gg, Gs^Es, Gg, Gs, Gs, Gs, Gs^Es, Hh, Hh^Fp, Mm, Mm, Mm, Hh, Gd, Gs, Gs^Es, Mm, Mm, Mm^Xm, Mm^Xm, Mm, Mm, Hh, Gg^Eff, Gg^Eff, Rb^Gvs, Rb^Gvs, Rb^Gvs, Rb^Gvs, Rb^Gvs, Rb^Gvs, Rb^Gvs, Rb^Gvs, Rb^Gvs, Rb^Gvs, Rb^Gvs, Rb, Rb^Gvs, Rb^Gvs, Rb^Gvs, Rb^Gvs, Rb^Gvs, Rb^Gvs, Rb^Gvs, Rb^Gvs, Rb^Gvs, Rb^Gvs, Rb^Gvs, Rb^Emf, Wwg, Wwg, Ww, Ww, Gg, Gg^Em, Gg^Efm, Ss, Ss, Gg^Efm, Ss, Rb, Rb, Uu, Uu, Uu
Uu, Uu, Uu, Gg, Gg, Ss, Ss, Ss, Ds, Ds, Ww, Ww, Wot, Ww, Wot, Wot, Hh, Hh, Mm, Mm, Ms^Xm, Ms^Xm, Ms^Xm, Mm, Mm, Mm, Mm, Md, Ms^Xm, Ms^Xm, Hh^Fp, Ww, Hh^Fp, Mm, Mm, Mm, Gg^Efm, Hh, Gg, Gg^Es, Gg, Gs^Es, Gs, Gs, Hh, Gs, Gs, Gs, Gg^Efm, Hh, Mm, Mm, Mm^Xm, Mm, Mm, Hh, Hh, Gs, Gg, Hh, Hh, Mm, Mm^Xm, Mm^Xm, Mm, Hh, Gs, Gg^Eff, Gg^Eff, Rb^Gvs, Rb^Gvs, Rb^Gvs, Rb^Gvs, Rb^Gvs, Rb^Gvs, Rb^Gvs, Rb^Gvs, Rb^Gvs, Rb, Rb, Rb^Gvs, Rb^Gvs, Rb^Gvs, Rb^Gvs, Rb^Gvs, Rb^Gvs, Rb^Gvs, Rb^Gvs, Rb^Gvs, Rb^Gvs, Rb^Gvs, Rb^Gvs, Ww, Ww, Gg^Efm, Gg^Efm, Gg, Ss, Gg, Sm, Sm, Ss, Ss, Sm, Sm, Uu, Uu, Uu
Uu, Uu, Uu, Ss, Ss, Ss, Ds, Gg^Efm, Ww, Ww, Wot, Wot, Ss, Wot, Gg, Hh, Gg, Hh, Mm, Ms^Xm, Ms, Ms^Xm, Ms, Ms^Xm, Ms, Mm, Mm^Xm, Ms^Xm, Mm, Hh^Fp, Hh^Efm, Hh^Fp, Mm, Mm, Mm, Mm, Hh, Gg, Gg, Gs, Hh, Gs, Hh, Gg^Efm, Hh^Efm, Hh^Fp, Hh, Gg, Gs, Hh, Mm, Mm^Xm, Mm, Mm, Mm, Mm, Hh, Gs^Es, Gg, Gg^Efm, Hh, Mm^Xm, Mm, Mm^Xm, Mm, Hh, Hh, Gs, Gs, Gg^Eff, Gg^Eff, Rb^Gvs, Rb^Gvs, Rb^Gvs, Uu, Rb^Gvs, Uu, Rb, Uu, Rb^Gvs, Uu, Rb^Gvs, Uu, Rb^Gvs, Uu, Rb^Gvs, Uu, Rb^Gvs, Uu, Rb^Gvs, Uu, Wwg, Uu, Ww, Uu, Gg^Efm, Uu, Ss, Uu, Sm, Uu, Ss, Uu, Gg, Uu, Uu, Uu, Uu
Uu, Uu, Uu, Ds, Sm, Sm, Ss, Ds, Ww, Wot, Wot, Gg^Efm, Ss, Ss, Ss, Hh, Gg, Hh, Hh, Ms, Ww, Ww, Ms, Ms, Mm^Xm, Mm^Xm, Mm^Xm, Mm, Mm, Hh, Hh, Mm, Ms, Mm, Mm, Hh, Gg, Gg, Gs, Hh, Gg^Efm, Hh, Mm, Mm, Mm, Mm, Mm, Hh, Hh, Gs, Gs, Hh, Mm, Mm, Mm, Mm, Hh, Hh, Hh, Hh, Hh, Hh^Fp, Mm, Mm^Xm, Mm^Xm, Hh, Hh, Gg, Hh, Hh, Hh, Gg^Eff, Gg^Eff, Rb^Gvs, Uu, Uu, Uu, Uu, Uu, Uu, Uu, Uu, Uu, Uu, Uu, Uu, Uu, Uu, Uu, Uu, Uu, Uu, Uu, Uu, Uu, Uu, Uu, Uu, Uu, Uu, Uu, Uu, Uu, Uu, Uu, Uu, Uu, Uu
Uu, Uu, Uu, Ww, Ww, Gg^Efm, Ww, Ww, Ww, Wot, Wot, Ss, Ww, Gg, Gg^Efm, Gg, Ww, Gg, Ww, Ww, Hh^Fp, Hh, Mm, Mm^Xm, Mm, Mm, Mm, Mm, Hh^Fp, Hh, Mm, Mm, Mm, Mm, Hh, Gg^Efm, Gs^Es, Hh, Hh, Hh, Mm, Mm, Mm, Mm, Mm^Xm, Mm^Xm, Mm, Mm, Hh, Gg, Gg, Hh, Mm, Mm, Mm^Xm, Mm, Hh, Gs^Es, Gg, Hh, Hh, Hh, Mm, Mm, Mm^Xm, Mm, Mm, Hh, Mm, Gg^Efm, Gg, Gs, Hh, Gg^Eff, Uu, Uu, Uu, Uu, Uu, Uu, Uu, Uu, Uu, Uu, Uu, Uu, Uu, Uu, Uu, Uu, Uu, Uu, Uu, Uu, Uu, Uu, Uu, Uu, Uu, Uu, Uu, Uu, Uu, Uu, Uu, Uu, Uu, Uu
Uu, Uu, Uu, Wot, Ww, Ww, Ww, Wot, Wot, Wot, Wot, Ww, Gg, Ww, Ww, Ww, Gg, Ww, Hh, Hh, Mm, Mm, Mm^Xm, Mm^Xm, Mm, Mm, Mm, Mm, Gg, Gg^Emf, Hh, Mm, Mm, Mm, Hh, Gg, Gs, Gg, Mm, Mm, Mm, Hh, Hh^Fp, Mm^Xm, Mm, Hh, Mm, Mm, Mm, Hh, Gg, Hh, Hh, Mm, Mm, Hh, Gg^Efm, Gg, Gs, Gs^Es, Gg, Hh, Mm, Mm, Mm, Mm^Xm, Mm^Xm, Mm, Mm, Mm, Mm, Hh, Hh, Gs, Uu, Uu, Uu, Uu, Uu, Uu, Uu, Uu, Uu, Uu, Uu, Uu, Uu, Uu, Uu, Uu, Uu, Uu, Uu, Uu, Uu, Uu, Uu, Uu, Uu, Uu, Uu, Uu, Uu, Uu, Uu, Uu, Uu, Uu
Uu, Uu, Uu, Wot, Wot, Wot, Wot, Wot, Wot, Wot, Ss, Gg^Efm, Hh^Efm, Hh, Gg, Gg^Efm, Hh, Hh, Mm, Mm, Mm, Mm^Xm, Mm, Mm, Mm, Mm, Hh, Hh, Gg^Efm, Hh, Mm, Mm, Hh, Hh, Gs, Gs, Gg, Hh, Mm, Mm, Mm, Mm, Ms^Xm, Mm^Xm, Mm^Xm, Mm^Xm, Mm, Mm, Hh, Hh, Gg, Gg, Mm, Mm, Mm, Hh, Hh, Gg, Gs, Gg, Gg, Hh, Hh^Fp, Mm, Mm, Mm^Xm, Mm^Xm, Mm, Mm, Mm, Mm, Hh, Hh, Gg, Uu, Uu, Uu, Uu, Uu, Uu, Uu, Uu, Uu, Uu, Uu, Uu, Uu, Uu, Uu, Uu, Uu, Uu, Uu, Uu, Uu, Uu, Uu, Uu, Uu, Uu, Uu, Uu, Uu, Uu, Uu, Uu, Uu, Uu
Uu, Uu, Uu, Gg, Ss, Wot, Ss, Ss, Gg^Efm, Gg, Hh, Hh, Hh, Hh^Efm, Hh, Hh^Fp, Mm, Mm, Mm, Mm, Mm, Mm^Xm, Mm^Xm, Mm, Mm, Hh, Hh, Gg, Gg, Hh, Mm, Hhd^Fdw, Hhd^Fdw, Gs, Gs, Gg, Gg^Efm, Hh, Mm, Mm, Mm, Ms, Ms, Mm, Mm, Mm, Mm, Mm, Gs, Gs, Hh, Mm, Mm, Mm^Xm, Mm, Mm, Hh, Gs, Gg, Gg, Gs, Hh, Hh^Fp, Mm, Mm, Mm, Mm, Mm^Xm, Mm^Xm, Ww, Mm, Mm, Mm, Hh, Uu, Uu, Uu, Uu, Uu, Uu, Uu, Uu, Uu, Uu, Uu, Uu, Uu, Uu, Uu, Uu, Uu, Uu, Uu, Uu, Uu, Uu, Uu, Uu, Uu, Uu, Uu, Uu, Uu, Uu, Uu, Uu, Uu, Uu
Uu, Uu, Uu, Gg, Uu, Ss, Uu, Gg, Uu, Gg, Uu, Hh, Uu, Hh, Uu, Hh^Fp, Uu, Mm, Uu, Mm, Uu, Mm, Uu, Mm^Xm, Uu, Hh, Uu, Gg, Uu, Gg, Uu, Mm, Uu, Gg, Uu, Gg, Uu, Hh, Uu, Mm, Uu, Ms, Uu, Mm, Uu, Mm, Uu, Gg, Uu, Gs, Uu, Mm, Uu, Mm^Xm, Uu, Gg, Uu, Gg, Uu, Gg, Uu, Gs, Uu, Hh^Fp, Uu, Mm, Uu, Mm, Uu, Mm^Xm, Uu, Gg, Uu, Hh, Uu, Uu, Uu, Uu, Uu, Uu, Uu, Uu, Uu, Uu, Uu, Uu, Uu, Uu, Uu, Uu, Uu, Uu, Uu, Uu, Uu, Uu, Uu, Uu, Uu, Uu, Uu, Uu, Uu, Uu, Uu, Uu, Uu, Uu
Uu, Uu, Uu, Uu, Uu, Uu, Uu, Uu, Uu, Uu, Uu, Uu, Uu, Uu, Uu, Uu, Uu, Uu, Uu, Uu, Uu, Uu, Uu, Uu, Uu, Uu, Uu, Uu, Uu, Uu, Uu, Uu, Uu, Uu, Uu, Uu, Uu, Uu, Uu, Uu, Uu, Uu, Uu, Uu, Uu, Uu, Uu, Uu, Uu, Uu, Uu, Uu, Uu, Uu, Uu, Uu, Uu, Uu, Uu, Uu, Uu, Uu, Uu, Uu, Uu, Uu, Uu, Uu, Uu, Uu, Uu, Uu, Uu, Uu, Uu, Uu, Uu, Uu, Uu, Uu, Uu, Uu, Uu, Uu, Uu, Uu, Uu, Uu, Uu, Uu, Uu, Uu, Uu, Uu, Uu, Uu, Uu, Uu, Uu, Uu, Uu, Uu, Uu, Uu, Uu, Uu, Uu, Uu
Uu, Uu, Uu, Uu, Uu, Uu, Uu, Uu, Uu, Uu, Uu, Uu, Uu, Uu, Uu, Uu, Uu, Uu, Uu, Uu, Uu, Uu, Uu, Uu, Uu, Uu, Uu, Uu, Uu, Uu, Uu, Uu, Uu, Uu, Uu, Uu, Uu, Uu, Uu, Uu, Uu, Uu, Uu, Uu, Uu, Uu, Uu, Uu, Uu, Uu, Uu, Uu, Uu, Uu, Uu, Uu, Uu, Uu, Uu, Uu, Uu, Uu, Uu, Uu, Uu, Uu, Uu, Uu, Uu, Uu, Uu, Uu, Uu, Uu, Uu, Uu, Uu, Uu, Uu, Uu, Uu, Uu, Uu, Uu, Uu, Uu, Uu, Uu, Uu, Uu, Uu, Uu, Uu, Uu, Uu, Uu, Uu, Uu, Uu, Uu, Uu, Uu, Uu, Uu, Uu, Uu, Uu, Uu
